гымнин ытльат ы’ттъуви ынкъам о’мрытваал	г ы м н и н ы т ь а т _ ы ’ т т ъ _ у в и ы н к ъ а м _ о ’ м р ы т в а а _
пууръу эпы гымнин о’м о’мрыквот нэмыӄэй ӄорагынрэтыльо нитӄин	п у у р ъ у э п ы г ы м н и н _ о ’ м _ о ’ м р ы к в _ о т _ н э м ы ӄ э й _ ӄ о р а г ы н р э т ы _ ь о _ н и т ӄ и н
гымнин ытлыгыт ытль’атэ ӄонпы эмнуӈкы нымигчирэтӄинэт нэмыӄэй ӄорагынрэтыльо нитӄинэт	г ы м н и н ы т ы г ы т ы т _ ь _ ’ а т _ э ӄ о н п ы э м н у ӈ к ы н ы м и г ч и р э т ӄ и н э т н э м ы ӄ э й _ ӄ о р _ а г ы н _ р э т ы _ ь о _ н и т ӄ и н э т
ынкъам мури гачакэттомга гэ гэегтэльмури каврагыргын ынкъам гым	ы н к ъ а м м у р и г а ч а к э т _ т о м г а _ г э _ г э е г т э _ ь _ м у р и к а в р а г ы р г ы н ы н к ъ а м г ы м _
ытръэче ӈирэӄ нэнэнэт вагъэт	ы т р ъ э ч е ӈ и р э ӄ н э н э н э т _ в а г ъ э т _
ытръэч	ы т р ъ э ч
кытур ынӈытэӄэ мэдвэдэв прэзидэнто энма канчалянэты гэрэмкичильин	к ы т у р ы н ӈ ы т э ӄ э _ м э _ д в э д _ э в п р э з и д _ э н т о э н м а к а н ч _ а я н э т ы _ г э р э м к и ч и ь _ и н
ынкъа люут ӈыръа вэрталёттэ вакъогъатӈа	ы н к ъ а ю у т _ ӈ ы р ъ а _ в э р т а _ ё т т э в а к ъ о г ъ а т _ ӈ а
ныныпчеӈивйивӄин колё нымныма мэдвэдэвъым	н ы н ы п ч е ӈ и в _ й и в ӄ и н к о ё н ы м н ы м а _ м э д _ в э д _ э в ъ ы м
гэчевкы нынтыӄин таӈколё ынкы ныгынритӄин	г э ч е в к ы н ы н т ы ӄ и н т а ӈ к о _ ё _ ы н к ы _ н ы г ы н р и т ӄ и н _
люутэ абрамович ӈыронвэрталёта вакъогъэ нэмыӄэй	ю у т э а б _ р а м о в и ч _ ӈ ы р о н в э р т а ё т а _ в а к ъ о г ъ э н э м ы ӄ э й
мэдвэдэв ивкэ лыгэн ынкы напэлягъан йъэлыги абрамович наягнагъан	м э д в э д _ э в и в к э ы г э н ы н к ы _ н а п _ э я _ г ъ а н _ й ъ э ы г и а _ б р а м о в и ч _ н а я г н а г ъ а н
инъэ гым нылӄутигым	и н ъ э г ы м н ы ӄ у т _ и г ы м _
янот нычайойгым	я н о т н ы ч а й о й г ы м _
нилгытэвигым ынкъам нывийгым нытапэтӈивым	н и г ы т э в и г ы м ы н к ъ а м _ н ы в и й г ы м н ы т а п _ э т _ ӈ и в ы м _
ванэ мычавтракгъак	в а н э м ы ч а в т _ р а к _ г ъ а к
апэтыплыткокэ	а п э т ы п ы т к о к _ э
игытъым ванэ гым м мымигчирэтгъэк	и г ы т ъ ы м в а н э г ы м _ м м ы м _ и г ч и р _ э т г ъ э к _
ныпэнчияйгым	н ы п э н ч и я й г ы м _
апэтыплыткокэ нотагты нылӄытивым элек	а п э т ы п ы т к о к _ э н о т а г т ы н ы ӄ ы т и в _ ы м _ э е к
нуунъыгичийгым чама ныпъоӈгэлейгым	н у у н ъ ы г и ч и й г ы м ч а м а _ н ы п ъ о ӈ _ г э _ е й г ы м
нырагтэгым	н ы р а г т э г ы м
уунъытэ	у у н ъ ы т э
ӈу нинэ нуй ӈуйӈуй нэ нэ нэнъупиратэвым	ӈ у н и н э _ н у й _ ӈ у й ӈ у _ й н _ э н э _ н э н ъ у п _ и р а т э в _ ы м
ынкъам плыткукъым натчьатэгым и ныйылӄэтигым	ы н к ъ а м п ы т к у к ъ ы м _ н а т ч ь _ а т э г ы м и н ы й ы ӄ _ э т и г ы м
льэлеӈкы пууръу нымигчирэтигым	ь э е ӈ к ы п у у р ъ у _ н ы м и г ч и р э т и г ы м
нылӄутигым инъэ	н ы ӄ у т и г ы м и н ъ э _
нычайойгым	н ы ч а й о й г ы м
мэгчерынвэты нытэнмавэвым ынкъам нымигчирэтысӄививым	м э г ч е р ы н в э т ы н ы т э н м а в э в ы м _ ы н к ъ а м _ н ы м и г ч и р э т ы с ӄ и в _ и в _ ы м
ынкы калеткорак нытэнъэткуйгым апэттагнэты	ы н к ы к а е т к о р _ ак _ н ы т э н ъ э т к у й г ы м _ а п э т т а г н э т ы
нырагтэгым напэтэгым	н ы р а г т э г ы м н а п _ э т э г ы м
апэтыплыткок нэмэ нымигчирысӄививым	а п э т ы п ы т к о к _ н э м э н ы м и г ч и р ы с ӄ и в _ и в _ ы м
ынкы нытэнъэткуйгым	ы н к ы н ы т э н ъ э т к у _ й г ы м _
ӈыраӄычьэты нырагтэгым	ӈ ы р а ӄ ы ч ь э т ы н ы р а г т _ э г ы м
нилгытэвивым ынкъам ярак нымигчирэтивым ч нытэнъэткуйгым чама нывийгым	н и г ы т э в и в _ ы м ы н к ъ а м я р а к н ы м и г ч и р э т и в _ ы м _ ч _ н ы т э н ъ э т к у _ й г ы м _ ч а м а н ы в и й г ы м
и имыръэнук имыръэнут ярак нинэтэйкивым чама нываӈэйгым	и и м ы р ъэн у к _ и м ы р ъ э н у т _ я р а к н и н э т э й к и в _ ы м _ ч а м а _ н ы в а ӈ э й г ы м
ынкъам мынгытычьэты натчьатэгым ныйылӄэтигым	ы н к ъ а м м ы н г ы т ы ч ь э т ы н а т ч ь а т э г ы м _ н ы й ы ӄ _ э т и г ы м _
гым ныппыльэв вама гарыч нырычвалыӈыттыӄэнат	г ы м н ы п п ы ь _ э в _ в а м а г а р ы ч н ы р _ ы ч _ в а ы ӈ ы т _ т ы ӄ э н а т
гым нэмыӄэй ны нырычвалыӈыттыӄэнат нэмыӄэй гым нывинрэтигым нырычвантойгым	г ы м н э м ы ӄ э й н ы н ы р _ ы ч _ в а _ ы ӈ ы т _ т ы ӄ э н а т н э м ы ӄ э й г ы м н ы в и н р э т и г ы м _ н ы р _ ы ч _ в а н т о й г ы м _
гым ӈавъёльа нинивӄин	г ы м ӈ а в ъ ё ь _ а _ н и н и в ӄ и н
ӄы нэмыӄэй ӄырычвогэ	ӄ ы н э м ы ӄ э й ӄ ы р _ ы ч в о _ г э _
ӄырым ӄырым мырычвогъак	ӄ ы р ы м ӄ ы р ы м м ы р ы ч _ в о _ г ъ а к _
тэӈвэнлыги рыпыткынтэвнинъым гэнанвытрынтэвлинъым	т э ӈ в э н ы г и р ы п _ ы т к ы н т э в н и н ъ ы м _ г э н а н в ы т р ы н т э в и н _ ъ ы м
рыпыткынтавъё тъынин	р ы п ы т к ы н т а в ъ ё _ т ъ ы н и н
трагтыгъак гым иниквъи	т р а г т ы гъак г ы м _ и н и к в ъ и
нивӄин гэрэӄигыт гилгыльувигыт	н и в ӄ и н г э р э ӄ и г ы т г и г _ ы _ ь _ у в и г ы т
наӄам эвыт тэӈэвыт ныпээттылейгым	н а ӄ а м э в ы т т э ӈ э в ы т _ н ы п _ э _ э т т ы _ е й г ы м
нинивӄин ытльата	н и н и в ӄ и н ы т ь а т а _
тумгытум ӄыгитэгэ мургин ынпыӈэв гэрэӄылин тэӈтэӈэвыт пэ пэ	т у м г ы т у м ӄ ы г и т э г э _ м у р г и н _ ы н п ы ӈ э в г э р э ӄ _ ы _ и н _ т э ӈ т э ӈ э в ы т _ п э п э
нылгиргыткульэтӄин ны ныннупэтӄинэт рыгыткогыргыт	н ы г и р г ы т к у ь _ э т ӄ и н н ы н ы н н у п э т ӄ и н э т _ р ы г _ ы т к о г ы р г ы т
ытчайаъым ӄэйвэ гинэльулинъым гэльулин рывытрынтавъё ынӄэн рычвалгын гэнпыткынтэвлин	ы т ч а й а ъ ы м ӄ э й в э _ г и н э ь у _ и н _ ъ ы м г э ь у и н _ р ы в ы т р ы н т а в ъ ё ы н ӄ э н _ р ы ч в а г ы н _ г э н п _ ы т к ы н т э в и н _
йыкыргын нинэйпыӄин нинивӄин ӄытитӄэтгын	й ы к ы р г ы н н и н э й п ы ӄ и н н и н и в ӄ и н ӄ ы т _ и т ӄ _ э т г ы н _
гымнан ванэ мытитӄэтгъэн	г ы м н а н в а н э м ы т и т ӄ _ э т г ъ э н _
вэнлыги чиӈкэйыръын ӄытлыги гэтитӄэтлин гымнан	в э н ы г и ч и ӈ к э й ы р ъ ы н _ ӄ ы т ы г и _ г э т и т ӄ _ э т и н _ г ы м н а н
тэӈэвыт тыпээттыляӈӈогъа гинив	т э ӈ э в ы т т ы п э _ э т т ы я _ ӈ ӈ о г ъ а г и н и в
нычаёӄэнат	н ы ч а ё ӄ э н а т
ытчайы гымнин ытля эну нэнамӈылёӄэна	ы т ч а й ы г ы м н и н ы т _ я э н _ у _ н э н а м ӈ _ ы ё ӄ э н а _
ӄутынъым ивнин	ӄ у т ы н ъ ы м и в н и н
ыныг ӈавъёльа йыкыргычыкогты гэнпыткынтэвлин рычвалгын	ы н ы г ӈ а в ъ ё ь _ а _ й ы к ы р г ы ч ы к о г т ы г э н п ы т к ы н т э в _ и н _ р ы ч в а г ы н
ытлыгын ӈаргынэн найвы айгычӄыӈӄач нывакъотваӄэн нырэӄыӄин ны ны нэнарынӈыӄин оттылгын	ы т ы г ы н ӈ а р г ы н э н н а й _ в ы а й _ г _ ы ч ӄ _ ы ӈ ӄ а ч н ы в а к ъ о т в а ӄ э н н ы р э ӄ ы ӄ и н н ы _ н ы _ н э н а р ы н ӈ _ ы ӄ и н _ о т т _ ы г ы н
ынкатагнэпы гатанпаайгым ынӄо рычвок	ы н к а т а г н э п ы г а т а н п а _ а й г ы м _ ы н ӄ о р ы ч в о к _
нэнанъотавӄэн рычвольэгым	н э н а н ъ о т а в ӄ э н р ы ч в о ь _ э г ы м _
нинивӄин ӄырычванторкын	н и н и в ӄ и н ӄ ы р ы ч в а н т _ о р к ы н _
ынӄоры паагъэ тынутчирык	ы н ӄ о р ы п а а г ъ э т ы н у т ч и р _ ы к _
ынкатагнэпы нырычвантойгым ӄонпы нык ныкэгынмилгытэвигым	ы н к а т а г н э п ы н ы р ы ч в а н т _ о й г ы м _ ӄ о н п ы н ы к н ы к э г ы н _ м _ и г ы т _ э в и г ы м
гымыкытчайаъым вэриву вэривуунъыкинэт гичининэт	г ы м ы к ы т ч а й а _ ъ ы м в э р и в у в э р и в у _ у н ъ ы к _ и н э т г и ч ининэт
рыпгыпгэвнин нинивӄин	р ы п г ы п г э в н и н _ н и н и в ӄ и н
ӄылпыгын гэмэч гэмэсӄытвилин виин	ӄ ы п ы г ы н г э м э ч г э м _ э с ӄ ы т в _ и и н _ в и и н
наӄам нинивигым	н а ӄ а м н и н и в и г ы м
иниквъи ӄарычгытвагэ	и н и к в ъ и ӄ а р ы ч г ы т в а г э _
нинэ ӄээӄын тарычгытвагъак	н и н э ӄ э э ӄ ы н т а р _ ы ч г ы т в а г ъ а к _
энэвӈӈогъэ гым	э н э в ӈ ӈ о г ъ э г ы м _
ӄылютэги	ӄ ы ю т э г и _
гымнан нивигым	г ы м н а н н и в и г ы м
ванэ мылётаӈӈогъак	в а н э м ы ё т а ӈ ӈ о _ г ъ а к _
вэнлыги ӄылютэги	в э н ы г и ӄ ы ю _ т э г и _
ынкатагнэпы ынӄо лыгэн энанъотавӈӈогъэ рычвольэгым	ы н к а т а г н э п ы ы н ӄ о ы г э н _ э н а н _ ъ о т _ а в ӈ ӈ о г ъ э _ р ы ч в о ь э г ы м _
ӄонпы ныкэгынмилгытэвигым	ӄ о н п ы н ы к э г ы н м _ и г ы т _ э в и г ы м
ынкатагнэпы гапаайгым	ы н к а т а г н э п ы г а п а айгым
ынӄо нивӄинэт иа’м ытлён ынӈин	ы н ӄ о н и в ӄ и н э т и а ’ м ы т _ ё _ н _ ы н ӈ и н _
ӄырым ытръэч игыт трэгичиркынэт томыкагты трэйылыркынэт	ӄ ы р ы м ы т р ъ э ч и г ы т т р _ э г _ и ч _ и р к ы н _ э т т о м ы к а г т ы т р э й ы _ ы р к ы н э т
игытъым тумгыт нивӄээт	и г ы т ъ ы м т у м г ы т н и в _ ӄ э э т _
ивкэ мынырычвомык	и в к э мын ы р ы ч в _ о м ы к _
гым вэлвагты нытвайгым	г ы м в э в а г т ы _ н ы т в а й г ы м _
гымнан ги гымнин гэчеёттэ тэӈэвыт томыкагты нинэйылигым рычват мэӈин гэчеёттэ тагъяӈӄэн рычвагты	г ы м н а н г и г ы м н и н г э ч е _ ё т т э _ т э ӈ _ э в ы т _ т о м ы к а г т ы _ н и н э й ы _ и г ы м р ы ч _ в а т м э ӈ и н г э ч е _ ё т т э т а г ъ я ӈ _ ӄ э н _ р ы ч в а _ г т ы
мэчынкы	м э ч ы н к ы
рыркайпияк мури калеткома ынӄэн	р ы р к а й п и я к м у р и _ к а е т к о м а _ ы н ӄ э н _
эмнуӈыльыт ныпкирӄинэт ынӄэнэ	э м н у ӈ ы ь ы т _ н ы п к и р ӄ и н э т ы н ӄ э н э
наӄамэ итык эвынъым нъэӄимлынӈэӄинэт вэлыткорайпыӈ	н а ӄ а м э и т ы к э в ы н _ ъ ы м н ъ э ӄ _ и м _ ы н ӈ э ӄ и н э т _ в э ы т к о р _ а й п ы ӈ
наӄам ӈанэ ӈиръэӄи	н а ӄ а м ӈ а н э ӈ и р _ ъ э ӄ _ и
э’ӄимлытъым алва вальыт ынӄэн ӄырымэнэ лыгъэӄимлыт ваа лыгэнэ наӄам нычелгльоӄэнат	э ’ ӄ и м ы т ъ ы м а в а _ в а ь ы т _ ы н ӄ э н _ ӄ ы р ы м э н э ы _ г ъ э ӄ _ и м ы т _ в а а ы г э н э _ н а ӄ а м _ н ы ч е г ь о ӄ э н а т _
мрэнти	м р э н т и
наӄам брэнди	н а ӄ а м б р э н д _ и _
брэнди брэндину нылгыӄинэтъым	б р э н д и _ б р э н д и н у _ н ы г ы ӄ и н э т ъ ы м
ӄутти ӄуттиы’м ынръамэ нэплички плисӄэнӈаӄэнат	ӄ у т т и ӄ у т т и ы ’ м _ ы н р ъ а м _ э н э п и ч _ к и п _ и с ӄ э н ӈ а _ ӄ э н а т
ӄоравальыт ӄэлюӄы’м пыкитльыт отпучкыльыт	ӄ о р а в а ь ы т _ ӄ э ю ӄ ы ’ м п ы к и т _ ь ы т о т _ п у ч к ы _ ь ы т
ӄутырыкъым ынӄэн брэнди	ӄ у т ы р ы к ъ ы м ы н ӄ э н б _ р э н д _ и _
мрэнтиы’м ынӄэн	м р э н т и ы ’ м _ ы н ӄ э н
ынпыначгын ӄоныры ынӄэнэ гавъёльатленъым	ы н п ы н а ч г ы н ӄ о н ы р ы ы н ӄ э н э _ г _ а в ъ ё _ ь а т _ е н ъ ы м
а’ачек эты нинивӄин	а ’ а ч е к э т ы н и н и в ӄ и н
ӄвэлыткорантагэъым вай ынкъам гымыкагты ӄыркургынэт	ӄ в э ы т к о р _ а н т а г э ъ ы м в а й ы н к ъ а м г ы м ы к а г т ы ӄ ы р к у р _ гынэт _
ынӄэн вэлыткоран пличка бличка	ы н ӄ э н в э ы т к _ о р _ ан п и ч к а б _ и ч к а
ӈан мрэнти ӄыркургынэт	ӈ а н м р э н т и ӄ ы р к у р _ гынэт _
ынӄэн гав чичеквъиы’м ӄэлюӄ а’ачекъым гэтэнӈыткулин	ы н ӄ э н г а в ч и ч е к в ъ и ы _ ’ м _ ӄ э ю _ ӄ а ’ а ч е к ъ ы м _ г э т э н ӈ _ ы т к у и н _
ытръэч ынӄэн пличка бличка иквъиы’м	ы т р ъ э ч ы н ӄ э н п и ч _ к а _ б _ и ч к а и к в ъ и _ ы ’ м
мытив ынӄэнэ танӈымэл иквъи чымчеӄэй	м ы т и в ы н ӄ э н э т а н ӈ _ ы м _ э и к в ъ и _ ч ы м ч е ӄ э й
пличка бличка чымчеӄэй вэлыткоран мрэнти ӄыркургынэт	п и ч к а б _ и ч к а ч ы м ч е ӄ э й _ в э ы т к _ о р _ ан м р э н т и ӄ ы р к у р гынэт _
ынӄэн а’ачекъым вэлыткорантаъэм ӄытлыги ымы плички курнинэтъым ымы мрэнти ын курнинэт	ы н ӄ э н а ’ а ч е к ъ ы м в _ э _ ы т к о р _ а н т а ъ э м ӄ ы т ы г и ы м ы п _ и ч к и _ к у р _ н и н э т ъ ы м ы м ы _ м р э н т и ы н _ к у р _ н и н э т
ынӄэн ынӈатал	ы н ӄ э н ы н ӈ а т а
нивӄинэт пличка нэмыӄэй	н и в ӄ и н э т п и ч к а _ н э м ы ӄ э й _
тэнмэмлыёчгын нытваӄэн	т э н м э м ы ё ч г ы н н ы т в а ӄ э н _
ынӄэната гакиноратленатъым клюпчыко	ы н ӄ э н а т а г а к ин о р а т _ е н _ а т ъ ы м к ю п ч ы к о _
клюбэты мури ымыльо кэлиткульымури ынӄэнэ нанвакъовсӄэвмык	к ю б э т ы _ м у р и ы м ы ь о к э _ и т к у _ ь ы м у р и _ ы н ӄ э н э н а н в а к ъ о в _ с ӄ э в м ы к _
ӄытлыгиы’м ынӄэнэ чапаевӄай чапаев ынӄэн мытльуэ’н кино тэӈвытку ӄэлюӄэ	ӄ ы т ы г и ы ’ м _ ы н ӄ э н э ч а п _ а е в ӄ а й _ ч а п а е в ы н ӄ э н _ м ы т ь у _ э ’ н _ к и н о т э ӈ в ы т к у ӄ э ю ӄ э _
ӈинӄэйӄэгти ӈээккэӄэгти ымыльо нывакъотваӄэнатъым	ӈ и н ӄ э й ӄ э г т и ӈ э э к к э ӄ э г т и ы м ы ь о _ н ы в а к ъ о т в а ӄ э н а т _ ъ ы м _
наӄам ӈоонко лыгэнъым вай ынӄэн	н а ӄ а м ӈ о о н к о ы г э н _ ъ ы м _ в а й _ ы н ӄ э н
нывыргыргыръуӄинъымӈэ у’рэӈэнри	н ы в ы р г ы р гыръ уӄин ъ ы м _ ӈ э у ’ р э ӈ э н р и
йъэлыги ынӄэн ӈоонко нинэгитэмури ынӄэн кино’м энмэн	й ъ э ы г и ы н ӄ э н _ ӈ о о н к о н и н э г и т э м у р и _ ы н ӄ э н _ к и н _ о ’ м э н м э н _
ынӄэн ыныкит чапаевӄай нын нэнъиръилемйигӈы нынтоӄэнъымэ	ы н ӄ э н ы н ы к и т ч а п _ а е в _ ӄ а й _ н ы н н э н ъ и р ъ и _ е м _ й и г ӈ ы н ы н т о ӄ э н ъ ы м э
наӄам ӈан ваал паколырговаляйӈын ӄнут	н а ӄ а м ӈ а н в а а п _ а к о _ ы р г о _ в а _ я й ӈ ы н ӄ н у т
ынӄэнэ левтык гырголя вай ынӈин нинэнилюйвыӄин нинэнилюйвыӄинъым	ы н ӄ э н э е в т ы к _ г ы р г о _ я в а й _ ы н ӈ и н н и н э н и _ ю _ й в ы ӄ и н _ н и н э н и ю й в ы ӄ и н _ ъ ы м
и ӈинӄэйӄэгти ӈээккэӄэгти ымыльо нивӄинэт	и ӈ и н ӄ э й ӄ э г т и ӈ э э к к э ӄ э г т и ы м ы _ ь о _ н и в ӄ и н э т _
урааа мургинэт ура мургинэт	у р а а а м у р г и н э т _ у р а м у р г и н э т _
ынӈатал гым нэмыӄэй ӄэлюӄы’м	ы н ӈ а т а г ы м н э м ы ӄ э й _ ӄ э ю ӄ ы _ ’ м _
нивигым э’тки а’ӄалеӈгыргын	н и в и г ы м э ’ т к и а ’ ӄ а е _ ӈ _ г ы р г ы н _
нэмыӄэйъымэ ӄынвэтъымэ тъэче гииӈитыкъымэ ӄынвэтэ амноӈэты нэмыӄэй киноратыӈӈоа’т	н э м ы ӄ э й ъ ы м э ӄ ы н в э т _ ъ ы м э т ъ э ч е _ г и и ӈ и т ы к _ ъ ы м _ э ӄ ы н в э т э а м н о ӈ э т ы _ н э м ы ӄ э й к и н о р а т _ ы ӈ ӈ о _ а ’ т _
ынпыначгытъым нэмыӄэй ныкиноӄэнат	ы н п ы н а ч г ы т ъ ы м н э м ы ӄ э й н ы к _ и н о ӄ э н а т _
ынлеко ымыӈ ытри аӈӄавъе ынӄэн нывакъотваӄэнат нэмыӄэйъым чыпэт тъэче малмытлыӈча нэгитээ’н ынӄэн ыннэнчьэн чапаевӄай	ы н е к о ы м ы ӈ _ ы т р и а ӈ ӄ а в ъ е _ ы н ӄ э н _ н ы в а к ъ о т в а ӄ э н а т _ н э м ы ӄ э й ъ ы м _ ч _ ы п _ э т т ъ э ч е _ м а м ы т ы ӈ _ ч а _ н э г и т э э ’ н ы н ӄ э н _ ы н н э н ч ь э н ч а п _ а е в _ ӄ а й _
ынлеко нивӄинэ ынлекона нинивӄинэ аӈӄавъе	ы н е к о н и в ӄ и н _ э ы н е к _ о н а н и н и в ӄ и н _ э а ӈ ӄ а в ъ е _
ынӈатал аръаля чапаевӄай этъуркыкыльи	ы н ӈ а т а а р ъ а я _ ч а п _ а е в ӄ а й _ э т ъ у р к ы к ы _ ь и
ӄольым нивӄин ӄун ии вэнъым э’тки	ӄ о ь ы м н и в ӄ и н _ ӄ у н и и в э н ъ ы м _ э ’ т к и _
ӈинӄэй ынкэкин нэмыӄэй миӈкыри танӈыӈэнӄай	ӈ и н ӄ э й ы н к э к и н н э м ы ӄ э й м и ӈ к ы р и _ т а н ӈ _ ы ӈ э н ӄ а й _
танӈыӈэнӄайа нэнамӈылёӄэн	танӈ ы ӈ э н ӄ а й а н э н а м _ ӈ ы ё ӄ э н
тури миӈкэк мэӈӄоры миӈкэкинэтури тури миӈкэкинэтури	т у р и м и ӈ к э к м э ӈ ӄ о р ы _ м и ӈ к э к и н э т у р и _ т у р и м и ӈ к э к и н э т у р и _
и иквъи ынӄэнэ ӈинӄэй гымнин	и и к в ъ и ы н ӄ э н э _ ӈ и н ӄ э й _ г ы м н и н _
мури вай амваанвыкэнайгым гым	м у р и в а й а м в а а н _ в ы к э н _ а й г ы м _ г ы м
ӄольым галгэ рилвыкымгытлинъым	ӄ о ь ы м г _ а г э р и в ы к ы м г ы т _ и н ъ ы м _
нивӄин гымнан гэмо ынӈин вальын нутэнут	н и в ӄ и н г ы м н а н г э м о ы н ӈ и н _ в а _ ь ы н _ н у т э н у т _
ӄэлюӄы’м ынӄэн ытлыгэ нэнавалёмӄэн вэтгавыльын ынӈинъым ынӄэн	ӄ э ю ӄ ы ’ м ы н ӄ э н _ ы т ы г э н э н а в а _ ё _ м ӄ э н _ в э т г а в ы ь ы н ы н ӈ и н _ ъ ы м ы н ӄ э н
ныний нынинъэйвыӄин экык	н ы н и й н ы н и н ъ _ э й в ы ӄ и н э к ы к _
ынӄэн гивэ мури вай чукоткайпы мытыпкирмык	ы н ӄ э н г и в э м у р и в а й _ ч у к о т к а й п ы _ м ы т ы п к и р м ы к _
чукоткакэнаморэ	ч у к о т к а к э н а м о р э
эээ ӄэлюӄы’м чичеквъи	э э э ӄ э ю ӄ ы _ ’ м ч и ч е к в ъ и _
ымы ынӄорыӈэ анадырык ынӄоры мытыпкирмыкъымэ	ы м ы ы н ӄ о р ы ӈ э а н _ а д _ ы р ы к ы н ӄ о р ы _ м ы т ы п к и р м ы к ъ ы м э _
ӄытлыги гымнин кэлиткутумгын ӄэргытваал ынӄэн	ӄ ы т ы г и г ы м н и н к э _ и т к у т у м г ы н _ ӄ э р _ г ы т в а а ы н ӄ э н _
мытльувылгымыкъым	м ы т ь у в ы г _ ы м ы к ъ ы м
ынин нэмыӄэй гымыкэккэнэ ынпычьэкыкъым ыннаны ынӄэнэ ыннэн ӄнут ыннэнгииӈикинэт ӈинӄэгти ынӄэн	ы н и н н э м ы ӄ э й г ы м ы к э к _ к э н _ э _ ы н п ы ч ь э к ы к ъ ы м ы н н а н ы _ ы н ӄ э н э ы н н э н _ ӄ _ н у т ы н н э н _ г и _ и ӈ и к _ и н э т ӈ и н ӄ э г т и ы н ӄ э н
нывэтгавӄэнат ӈирэргэри	н ы в э т г а в ӄ э н а т ӈ и р э р г э р и
ынӄэнэ энмэнъым чашкано гэтэныннынлин	ы н ӄ э н э э н м э н ъ ы м _ ч а ш _ к а н о _ г э т э н ы н н ы н и н
гымнан нинивигым вай ынӄэнъым данилка	г ы м н а н н и н и в и г ы м в а й ы н ӄ э н _ ъ ы м _ д _ а н и к _ а
ынӄэн нывэтгавӄэнат	ы н ӄ э н н ы в э т г а в ӄ э н а т
люут ынӄэн нэнан мытвалёмынат ивыльыт	ю ут ы н ӄ э н н э н а н _ м ы т в а ё _ м ы н _ а т _ и в ы ь ы т _
чашкана данилка нэнамӈылёӄэн	ч а ш к а н а _ д а н и к а н э н а м _ ӈ ы ё ӄ э н
гытъым миӈкэки мэӈӄоры пыкиргъи	г ы т ъ ы м м и ӈ к э к _ и м э ӈ ӄ о р ы _ п ы к и р г ъ и
миӈкэкинэйгыт	м и ӈ к э к и н э й г ы т
гым вай чукоткакэнайгым	г ы м в а й ч у к о т к а к э н а й г ы м _
ооо гым нэмыӄэй чукоткакэнайгым	о о о г ы м н э м ы ӄ э й _ ч у к о т к а к э н а й г ы м _
ытръэчьым ынӄэн миӈкэкинэйгыт ипэ	ы т р ъ э ч ь ы м ы н ӄ э н _ м и ӈ к э к и н э й г ы т и п э
омваанвыкэнайгым	о м в а а н в ы к э н _ а й г ы м
гым нотапынмэпы тыпки нэмыӄэй нутэпынмыльивым	г ы м н о т а п ы н _ м э п ы _ т ы п к и н э м ы ӄ э й н у т _ э п ы н м _ ы _ ь и в ы м
ынӄэнъым мури ӄэлюӄы’м мыттанӈыткоӈӈомык ипэ ынӄэн	ы н ӄ э н ъ ы м м у р и ӄ э ю _ ӄ ы ’ м _ м ы т т _ а н ӈ ы т к о ӈ ӈ о м ы к _ и п э ы н ӄ э н
гым паӈэ’вӈытъылёк	г ы м п а ӈ э ’ в _ ӈ ы т _ ъ ы ё к
вэтгавъёлгыткоэ’ айгытваалына иниквъи	в э т г а в ъ ё г ы т к о э ’ _ а й г ы т в а а ы н а _ и н и к в ъ и
эпэӄэй элгыӄанъявэты мынги мынилгытэвысӄивмык	э п э ӄ э й э г ы ӄ а н ъ я _ в э т ы _ м ы н г и м ы н и г ы т _ э в ы с ӄ _ и в м ы к
гымнанъым тиквъэк эгэй ытръэчьым ръэнут мынпиринэт	г ы м н а н ъ ы м т и к в ъ э к э г э й _ ы т р ъ э ч ь _ ы м _ р ъ э н у т _ м ы н п и р и н э т _
иниквъи ӄычавполпэрэгэ’м ынкъам пъомпъомъёчгынъым ынкъам эчг илгытэвкинэт яаёлӄылтэ	и н и к в ъ и ӄ ы ч ав п _ о п э р _ э г э ’ м ы н к ъ а м п ъ о м п _ ъ о м _ ъ ё ч г ы н ъ ы м ы н к ъ а м э ч г и г ы т _ э в _ к и н э т я а ё _ ӄ ы т э
тытэнмаквъакъым	т ы т э н м а к в ъ а к ъ ы м _
тыч тынвэтгавъёлгытковын тивын миӈкыри мылӄытык	т ы ч т ы н в э т г а в ъ ё _ г ы т к о _ в ы н т и в ы н м и ӈ к ы р и м ы ӄ ы т ы к _
ынан иниквъи нанэ ковлёрвоо ковлёрва мыт мытрэетгъэ гыныгъярагты	ы н а н иниквъи н а н э _ к о в _ ё р _ в о о _ к о в ё р в а м ы т _ м ы т р э е т г ъ э г ы н _ ы г ъ я _ р а г т ы
ынкы нэнъатчайгым	ы н к ы н э н ъ а т ч а й г ы м _
етгъэтъым мытэквэнмык элгыӄанъявэты	е т г ъ э т ъ ы м м ы т э к в энмык _ э г ы ӄ _ а н ъ я в э т ы _
тыляма нынвилмури’м ныпъоӈгэлеморэ	т ы я м а н ы н в _ и м у р и ’ м _ н ы п ъ о ӈ г э _ е м о р э
мытмачпъоӈгэлемыкъым чама ковлёрвыткольын митя ынин экык мытынӄамэтвавын	м ы т м а ч п ъ о _ ӈ г э е м ы к ъ ы м ч а м а к о в ё р в ы т к о _ ь ы н _ м и т я ы н и н э к ы к _ м ы т ы н ӄ а м э т в а _ в ы н _
ӄы ӄы ӄэлёӄы’м я епэчги ачайоӄыӄамэтвакыльэн ынӈин лыгэн мытэквэнмык	ӄ ы ӄ ы _ ӄ э ё _ ӄ ы ’ м _ я е п э ч г и а ч _ а й _ о ӄ ы ӄ _ а м э т в а к ы ь э н ы н ӈ и н ы г э н м ы т э к в _ энмык _
ынӄо илгыӄэнъевы мытыпкирмыкъым	ы н ӄ о и г ы ӄ э н ъ е в _ ы _ м ы т ы п к и р м ы к ъ ы м
мытилгытэвмыкъым	м ы т и г ы т э в м ы к _ ъ ы м
вэлыткорайпы мыттамыкъым мытxлепынӈэмыкъым	в э ы т к о р _ а й п ы м ы т т а м ы к ъ ы м м ы т _ е п ы н ӈ э м ы к _ ъ ы м
лыгэн имыръэнутэт мытпиринэтъым	ы г э н и м ы р ъ э н у т э т м ы т _ п и р и н э т _ ъ ы м _
ынӄо мытрагтымык	ы н ӄ о м ы т р а г т ы м ы к _
ытръэч	ы т р ъ э ч
пытӄайвэ мури ӄайкаврагыргын элгыӄанъявӈытаморэ эмрилгытэвӈэ	п ы т ӄ а й в э м у р и _ ӄ а й к а в р _ а г ы р г ы н _ э г ы ӄ а н ъ я в _ ӈ ы т а м о р э э м р и г ы т э в _ ӈ э
мытыпкирмык мытылгитэӈилгытэвмык гэлгитэӈычьэнмури	м ы т ы п к и р м ы к м ы т ы г и т э ӈ _ и г ы т _ э в м ы к г э г и т э ӈ ы ч ь э н м у р и
ӈоонрэ тыляма элгыӄанъявэты гэмэчпъоӈгэлеморэ	ӈ о о н р э т ы я м а э г _ ы ӄ _ а н ъ я в э т ы _ г э м э ч п ъ о ӈ _ г э е м о р э
палӄынтанма элгыӄанъяквыпы нэмыӄэй гамачпъоӈгэлеморэ	п а ӄ ы н т а н м а _ э г ы ӄ а н ъ я к в _ ы п ы н э м ы ӄ э й г а м а ч п ъ о _ ӈ _ г э е м о р э
илгыӄэнъевык нымэлмэлетӄин наӄам мурык нилетӄин	и г ы ӄ э н ъ е в ы к _ н ы м э м э е т ӄ и н _ н а ӄ а м м у р ы к н и _ е т ӄ и н _
ынӄэн ӈуткэкин морыкаӈӄачормыльынэ аӈӄай нытваӄэн эӈэӈыльын	ы н ӄ э н ӈ у т к э к и н м о р ы к а ӈ ӄ а ч о р _ м ы _ ь _ ы н э а ӈ ӄ а й н ы т в а ӄ э н э ӈ э ӈ _ ы ь ы н _
лымынӄо нылейвыӄин	ы м ы н ӄ о н ы е й в ы ӄ и н _
къама ӄол нэнтыгъэн ынӄэнэ эвына ӄолӄочатльанма нэпиригъэн ӈутку танӈа	к ъ а м а ӄ о _ н э н т ы г ъ э н ы н ӄ э н э _ э в ы н _ а _ ӄ о ӄ о _ ч а т ь _ а н м а н э п и р и г ъ э н ӈ у т к у т а н ӈ а
нэпиригъэнъым	н э п и р и г ъ э н ъ ы м
ӈайыӄытрык вай ынкы нынтыӄинэт ынӄэн эӈэӈыльыт ынӄэ	ӈ а й ы ӄ ы т р ы к _ в а й ы н к ы н ы н т ы ӄ и н э т ы н ӄ э н _ э ӈ э ӈ _ ы _ ь _ ы т _ ы н ӄ э
чит ынӄэнэ	ч и т ы н ӄ э н э
пэрэнвыкъымэ оттычанляйӈычыко нэ ныёйвыӄэн ныёӄэн рэнэ пылвынты рыпылвынтылгав вальын о’мрэты оттычанляйӈынъым	п э р э н в ы к ъ ы м _ э о т ты ч а н я _ й ӈ ы ч ы к о н э н ы ё й в ы ӄ э н _ н ы ё ӄ э н _ р э н э _ п ы в ы н _ т ы р ы п _ ы в ы н т ы г _ а в в а ь ы н о ’ м р э т ы _ о т ты _ ч а н я _ й ӈ ы н ъ ы м
ынкы нычамогъевӄэн тынык пэ нымкыӄин чамокытъым	ы н к ы н ы ч а м о _ г ъ _ е в ӄ э н т ы н ы к п э н ы м к ы ӄ и н _ ч а м о к _ ы т ъ ы м _
ӄорыӈэ нэргыръоӄаат эвын чанляткынык гырголӈэ нывакъотваӄэн эвын чамоктэ йъэнкыӈ ынкы гэгтыткулеэт йъэнкыӈ нотач ы’лыткынык нытваӄэнат	ӄ о р ы ӈ э н э р г ы р ъ о _ ӄ а а т э в ы н _ ч а н я т к ы н ы к _ г ы р г _ о ӈ э н ы в а к ъ о т в а ӄ э н _ э в ы н ч а м о к _ т э _ й ъ э н _ к ы ӈ ы н к ы г э г т _ ы т к у е _ э т _ й ъ э н к ы ӈ н о т а ч _ ы ’ ы т к ы н ы к _ н ы т в а ӄ э н а т
тытыл ааӈкы	т ы т ы а а ӈ к ы
нымӈылёӄэн ытлён гэрэӄигыт кытвылӄун миӈкыри ганточгатэгыт	н ы м ӈ ы ё ӄ э н ы т ё _ н г э р э ӄ и г ы т _ к ы т в ы ӄ у н м и ӈ к ы р и _ г а н т _ о ч г а т _ э г ы т _
нивӄин плеэн пчемытъэт ытръэч гъачаӈӈойгым	н и в ӄ и н п е э н п _ ч е м _ ы т ъ э т _ ы т р ъ э ч г ъ а ч а ӈ ӈ о _ й г ы м _
ипэмиӈкыри рээн нынтыӄин рээн нынлывэтӄин	и п э м и ӈ к ы р и р э э н н ы н т ы ӄ и н _ р э э н н ы н _ ы в _ э т ӄ и н _
ӄол нэнтыгъэн нэнлывэтгъэнъым	ӄ о н э н т ы г ъ э н н э н ы в _ э т г ъ э н _ ъ ы м _
люутэ нивӄээт этаны уйӈэ нъэлгъи	ю у т э н и в ӄ э _ э т э т а н ы _ у й ӈ э н ъ э г ъ и _
люут ӈоонӄо омкытагнэпы пинтыӄэтгъи о’ро о’о о’раырыкагты нылеӄин	ю ут ӈ о о н ӄ о о м _ к ы т а г н э п ы _ п и н т ы ӄ э т г ъ и _ о ’ р о о ’ _ о _ о ’ р а ы р ы к _ а г т ы н ы е _ ӄ и н
льэльэнры ӄынвэт льэленръугъи’м	ь э ь э н р _ ы ӄ ы н в э т ь э е н _ р ъ у г ъ и _ ’ м
чымче ынкы вальын ыёогыргын омваанвыкэнъым	ч ы м ч е ы н к ы в а ь ы н _ ы _ ё _ о г ы р г ы н о м _ в а а н в ы к э н _ ъ ы м
льиннык навыквынэлгэтгъэнъым ынкы нэнпылӄэквъэн	ь и н н ы к н _ а в ы к в ы н э г _ э т г ъ э н ъ ы м ы н к ы н э н п ы ӄ э к в ъ э н _
нэнпылӄэвынъым	н э н п ы ӄ э в ы н ъ ы м _
люут ӈоонӄо ӄолеыёогыргытагнэпыӈ выйигиӈэтэӈэ янот ынӄэнэ галгаӄай люут ыёогыргытагнэпы пиврэъим	ю ут ӈ о о н ӄ о ӄ о _ е ы ё _ о _ г ы р г ы т а г н э п ы ӈ в ы й и г и ӈ э т _ э ӈ э я н о т ы н ӄ э н э г а г _ а ӄ а й _ ю у т _ ы ё _ о г ы р г ы т _ а г н э п ы п и в р э ъ и м
пиврэ ынӄоры риӈэъи виг йыӈачыкогт йыӈэчыкутгъи ры ыны ыныгнотаӈӄачагты эквэтгъи	п и в р э ы н ӄ о р ы р и ӈ _ э ъ и _ в _ и г й ы ӈ а ч ы к о _ г т й ы ӈ _ э ч ы к у т г ъ и _ р ы ы н ы _ ы н ы г н о т _ а ӈ ӄ а ч а г т ы э к в э т г ъ и _
ӄолетъылёӈы ынӈэнӄачайпы ӄулийъилгыкэ пыкиргъиӈэ пыкиръэт магляльытъым иквъэт	ӄ о е т ъ ы ё _ ӈ ы ы н ӈ э н ӄ а ч а й п ы ӄ у и й _ ъ и г ы к э _ п ы к и р г ъ и ӈ э п ы к и р ъ э т _ м а г _ я ь _ ы т ъ ы м и к в ъ э т
вынэ ӈан яра нытваӄэн	в ы н э ӈ а н я р а _ н ы т в а ӄ э н _
ынкы ярак тъылыӈӈогъэ чычетпэлӄэтэ итгъи	ы н к ы я р а к т ъ ы _ ы ӈ ӈ о г ъ э _ ч ы ч е т _ п э ӄ э т э _ и т г ъ и
ынӄэн этъым аӈӄак нъанэлёӄэн эчкимоч нэмэ	ы н ӄ э н э т ъ ы м а ӈ ӄ а к н ъ _ а н _ э ё _ ӄ э н _ э ч к и м о ч н э м э _
ынӄэнэ гэлыткынгыпы янотэ а’нэлётаӈа нинъэйӈэвӄаат ыннытэ мэй мэйӈыръаваӈӄытъана’м	ы н ӄ э н э г э ы т к ы н г ы п ы _ я н о т э _ а ’ н э _ ё т а ӈ а _ н и н ъ э й ӈ э в ӄ а а т ы н н ы т э _ м э й м э й ӈ _ ы р ъ а в а _ ӈӄ _ ы т ъ а н а ’ м
ынӄорыӈа ӈыронванныльына черунэӈ ӈалгычаронаӈыльын эюпинэӈ ынӄэнатаӈэ	ы н ӄ о р ы ӈ а ӈ ы р о н в а н _ н ы ь _ ы н а ч е р у н э ӈ ӈ а г ы ч _ а р о н _ а ӈ ы ь ы н э ю п и н э ӈ ы н ӄ э н а т _ а ӈ э
рыпыткэвнинэт черутэ нэнагтоӄэнатъыма	р ы п ы т к э в н и н э т ч е р у т э _ н э н а г т о ӄ э н а т _ ъ ы м а
ынӈинэ эчкимочтэ нъанэлёӄэнат	ы н ӈ и н э э ч к и м _ о ч т э _ н ъ а н э ё ӄ э н а т _
ынӄорыӈа	ы н ӄ о р ы ӈ а
ынӄэнэ аӈӄалыгэнниӈыт гэчымъэв нывинӄээт гилйиӈкы вальыт	ы н ӄ э н э а ӈ ӄ а _ ы г э н н _ и ӈ ы т г э ч ы м ъ э в н ы в и н _ ӄ э э т г _ и й и ӈ к ы в а _ ь ы т
ныгилйиӈэтӄээтъым ынкъамэ	н ы г и й и ӈ э т ӄ э _ э т ъ ы м ы н к ъ а м э
ынӄэнатаӈэ	ы н ӄ э н а т а ӈ э
ынӄэнатаӈ нычеруйивӄинэтъым	ы н ӄ э н а т а ӈ н ы ч е р _ у й и в ӄ и н э т _ ъ ы м
ныгтоӄэнат	н ы г т о ӄ э н а т
ӄорыӈ энтк гэтэйкылин кинокэ	ӄ о р ы ӈ э н т _ к г э т _ э й к ы и н к и н о к _ э
ы’твыӄэй пэнин ыргин	ы ’ т в ы ӄ э й п э н и н ы р г и н _
гымнан гэмо ӄэлюӄ мури ӄорагынрэтыльыморэ	г ы м н а н г э м о ӄ э ю ӄ _ м у р и _ ӄ о р _ а г ы н р э т ы _ ь _ ы м о р э
ытръэч ынӄэнэ	ы т р ъ э ч ы н ӄ э н э
нымкъэв гэннулин нырагтыӈӈоӄэн	н ы м к ъ э в г э н н у и н _ н ы р _ а г т ы ӈ ӈ о ӄ э н
ынӈин киноплыткуъи	ы н ӈ и н к и н о п ы т к у _ ъ и _
гымнин гымнин ытля тэленъеп ганрагтатлен гымыкытлыгэ	г ы м н и н г ы м н и н ы т я _ т _ э _ е н ъ е п г а н р а г т _ а т е н г ы м ы к _ ы т ы г э
гымнин ытля тэленъеп ганрагтатлен ытлыгэ ринтыкэвнэ	г ы м н и н ы т я т _ э _ е н ъ е п г а н р а г т _ а т е н ы т _ ы г э р и н т ы к э в _ н э
ныннын гымынин ытльакэн рултыӈэвыт	н ы н н ы н г ы м ы н и н _ ы т ь _ а к э н р _ у т ы ӈ э в ы т _
рултыӈэвыт ытльата мури нэнмэйӈэвмык ытлыгэ чавчывак	р у т ы ӈ э в ы т _ ы т ь а т а м у р и _ н э н м э й ӈ э в м ы к _ ы т _ ы г э ч а в ч ы в а к
мури ганымытваморэ майӈыярачыко ии	м у р и г а н ы м ы т в а м о р э м а й ӈ ы я р _ а ч ы к о _ и и
чит майӈыярачыко ӈиръэ ёрот ёрот	ч и т м а й ӈ ы я р а ч ы к о ӈ и р ъ э _ ё р о т _ ё р о т
ӄолеёрочыкоӈы’м нытваӄэнат эпэӄэй эпы	ӄ о е ё р о ч _ ы к о ӈ ы ’ м н ы т в а ӄ э н а т э п э ӄ э й э п ы _
гымнин ытля нылгиным нэрмэӄин	г ы м н и н ы т я н ы г _ и н _ ы м н э р м э ӄ и н _
чама нылгинымигчирӄинэт ынин мынгыт	ч а м а н ы г и н ы м _ и г ч и р _ ӄ и н э т ы н и н м ы н г ы т
колё мэ мынгыт маманэн ӄонпы нымигчирэтӄинэт нытэнэлгыӈӄинэт нувиӄинэт наймыӄэнат	к о ё м э м ы н г ы т _ м а м а н э н _ ӄ о н п ы _ н ы м и г ч и р э т ӄ и н э т _ н ы т э н э г _ ы ӈ ӄ и н э т _ н у в _ и ӄ и н э т н а й м ы ӄ э н а т
танъярачыко нэнмэйӈэвмык ытльата ӄэльу ынан гэтэйкылин рэтэм яракэн	т а н ъ я р а ч ы к о н э н м э й ӈ э в _ м ы к ы т _ ь а т а ӄ _ э ь у _ ы н а н г э т э й к ы и н _ р э т э м _ я р а к э н
таӈванэван мури мын мынӈо’мык	т а ӈ в а н э в а н м у р и м ы н м ы н _ ӈ о _ ’ м _ ы к _
майӈыӈэлвыл мурык гэнмэйӈэвлин ытлыгэ чама эпэнэ	м а й ӈ ы ӈ э в ы м у р ы к _ г э н м э й ӈ э в и н _ ы т _ ы г э ч а м а э п э н э _
энмэн гатвален валвийӈын	э н м э н г а т в а е н в а _ в _ и й ӈ ы н
ымы игыт варкын	ы м ы и г ы т в а р к ы н
ытръэч	ы т р ъ э ч
ӄээӄын	ӄ э э ӄ ы н
ӄээӄын мылымӈылгъэк	ӄ э э ӄ ы н м ы ы м ӈ ы г ъ э к _
энмэн гатвален валвийӈын	э н м э н г а т в а е н в а _ в _ и й ӈ ы н
игыт ымы варкын	и г ы т ы м ы в а р к ы н
ытръэч	ы т р ъ э ч
ӄээӄын	ӄ э э ӄ ы н
мачква мури ӄэлюӄы’м гэтумгиинэтэ ӈиръэ ӈинӄэгти мурыгрээн нэмыӄэй	м а ч к в а м у р и ӄ э ю _ ӄ ы ’ м _ г э т у м _ г и и н э т э _ ӈ и р ъ э ӈ и н ӄ э г т и м у р ы г р э э н _ н э м ы ӄ э й _
гамачквантат ынӄэнъымэ гавэлыткорантаморэ’м	г а м а ч к в а н т а т _ ы н ӄ э н ъ ы м э г а в _ э ы т к о р _ а н т а м о р э ’ м
вэнъым нымэйыӈӄин ӄоныры лыгэнылгинивлыӄин чама	в э н ъ ы м н ы м э й ы ӈ ӄ и н ӄ о н ы р ы _ ы г э н _ ы г и н и в _ ы ӄ и н _ ч а м а
мыг мы мы нымэйыӈӄин вэлыткоран ынӄэн	м ы г м ы м ы н ы м э й ы ӈ ӄ и н _ в _ э _ ы т к _ о р _ ан ы н ӄ э н
гырголят гырголя гырголяйпы нылейвымури ынӄэн нинэгитэмури имыръэнут лыгэнэ	г ы р г о я т г ы р г _ о я г ы р г _ о я й п ы _ н ы е й в ы м у р и ы н ӄ э н _ н и н э г и т э м у р и и м ы р ъ э н у т _ _ ы г э н э _
ӄытлыги плеӄӄэгти ты тыльунэт	ӄ ы т ы г и п е ӄ ӄ _ э г т и т _ ы т ы _ ь у н э т _
нивигым ынӈатал йыӄӄайъым вай ынӄэнат плеӄӄэгтиы’м	н и в и г ы м ы н ӈ а т а й ы ӄ ӄ а й ъ ы м _ в а й _ ы н ӄ э н а т п е _ ӄ ӄ _ э г т и _ ы _ ’ м
кытэӄэй тыгитэнэтъым ынӄо	к ы т э ӄ э й т ы г и т э н э т _ ъ ы м _ ы н ӄ о
у’рэӈунри тылиэ’ э’ми тылельыт ы’ттъыёлкэнат	у ’ р эӈ у н р и _ т ы и э ’ э ’ м и _ т ы е ь _ ы т _ ы ’ т т ъ ы ё к э н а т
тынтымӈэвынат	т ы н т ы м ӈ э в ы н а т
нивигым э’ми ынръам	н и в и г ы м э ’ м и ы н р ъ а м
тылӄырэрыӈӈонат ӄэлюӄы’м	т ы ӄ ы р э р ы ӈ ӈ о н а т _ ӄ э ю ӄ ы ’ м
лымынӄо нылейвигым чама гыргочаткынэпы чама ӄынвэт	ы м ы н ӄ о н ы е й в _ игым ч а м а _ г ы р г о ч а т к ы н э п ы _ ч а м а _ ӄ ы н в э т
ив тивтылетгъэкъым тынтоа’к	и в т и в т ы е т _ г ъ э к _ ъ ы м т ы н т о а ’ к
ыннэнчьэн тытыл тынтоа’нъым тъатчаӈӈоа’к ынӄэн нын	ы н н э н ч ь э н т ы т ы т _ ы н т о _ а ’ н ъ ы м _ т ъ а т ч а ӈ ӈ о а ’ к _ ы н ӄ э н н ы н
нивигым алымы мэлнымкыӄинэ тытлытыл ӈотӄоры ӈытогыргын вальын	н и в и г ы м а ы м ы _ м _ э н ы м к ы ӄ и н э _ т ы т ы т ы ӈ о т ӄ о р ы _ ӈ ы т о г ы р г ы н в а _ ь ы н _
нымкыӄин тытлытыл алымы	н ы м к ы ӄ и н т ы т ы т ы _ а _ ы м ы
опопыӈа э’митлён мэмлыфантан мыйъоа’н	о п о п ы ӈ а э ’ м ит _ ё н _ м э м ы ф а н т _ а н м ы й ъ о а’н
нылейгым гыргочаткын гыргоча ынӄэн нинэгитэйгым э’митлёнэ фантан	н ы е й г ы м г ы р г о ч а т к ы н _ г ы р г о ч а ы н ӄ э н _ н и н э г и т э й г ы м э ’ м _ ит _ ё _ н э _ ф а н т а н
ӄытлыги ынӄэн люутэ энаркып энаркыпчыткогъэ ӈинчьэккэтэъым	ӄ ы т ы г и ы н ӄ э н ю _ у т э э н а р _ к ы п _ э н а р к ы п _ ч ы т к о г ъ э _ ӈ и н ч ь э к к э т э ъ ы м _
нивигым оо мэӈин	н и в и г ы м о о м э ӈ и н
о’мрын ӄытлыги	о ’ м р ы н ӄ ы т ы г и _
ынӄэн о’мрынына	ы н ӄ э н о ’ м р ы н ы н а _
э’ми ӄуттиӈэ э’миы’мэ э’ми атэӄай ымы э’ми ынъэӄэй	э ’ м и ӄ у т т и ӈ э _ э ’ м и _ ы ’ м э _ э ’ м и а т э ӄ а й ы м ы _ э ’ м и _ ы н ъ _ э ӄ э й _
ӈоонӄо ынъэӄэй фантанык ӄача нытваӄэн	ӈ о о н ӄ о ы н ъ э ӄ э й _ ф _ а н т а н ы к _ ӄ а ч а н ы т в а ӄ э н
атэӄайына нэлӄыричыӄи нэлӄырирчыӄиквыт	а т э ӄ а й ы н а н _ э ӄ ы р и ч _ ы ӄ и н э ӄ ы р и р ч ы ӄ _ и к в ы т
еээй ынӈатал э’тки нивигым вай тынтымӈэвтык	е э э й ы н ӈ а т а _ э ’ т к и н и в и г ы м _ в а й т ы н т _ ы м ӈ э в _ т ы к _
ынӄэнъымэ тыйъоа’нат лым	ы н ӄ э н ъ ы м э т ы й _ ъ о а ’ н а т _ ы м
иа’м мэӈӄоры нылейвыльэтигыт	и а ’ м м э ӈ ӄ о р ы н ы е й в _ ы _ ь _ э т и г ы т
мытынтымӈэквыт	м ы т ы н т ы м ӈ э к в ы т
ынкъам тымӈэвыркын иа’м ынӄэн	ы н к ъ а м т ы м ӈ э в ы р к ы н и а ’ м _ ы н ӄ э н _
а’йыӈ э’йӈэльэтгъи кытэӄэй ӄэлюӄ эт	а ’ й ы ӈ э ’ й ӈ э _ ь э т г ъ и к ы т э ӄ э й _ ӄ э ю ӄ э т _
ӄытлыги’м ынӄэн вэтчатваӈӈоэ’’м	ӄ ы т ы г и ’ м ы н ӄ э н _ в э т ч а т в а ӈ ӈ о э ’ ’ м _
яраруӄӄэмлылеӈэвъэнӄэй	я р а р у ӄ ӄ э м ы е ӈ э в ъ э н _ ӄ э й
гымнин ытльаӄай нырэлгыӄанъявӈытаӈӄэн	г ы м н и н ы т ь а ӄ а й _ н ы р _ э г ы ӄ а н ъ я _ в ӈ ы т а ӈ ӄ э н
нивӄин э’птэ гым ивкэ мэлгыӄанъявӈытаа’к	н и в ӄ и н э ’ п т э г ы м и в к э _ м э г _ ы ӄ _ а н ъ я _ в _ ӈ ы т а а ’ к
ынкъам мъэӄимлынӈээ’к	ы н к ъ а м м ъ э ӄ и м _ ы н ӈ э _ э ’ к
гымнан тивын	г ы м н а н т и в ы н
э’тки ынӄэн ынӄэнэ	э ’ т к и ы н ӄ э н ы н ӄ э н э _
э’тки ынӈэ ынӄэн ягмалеччо нэрэтчыгыт	э ’ т к и ы н ӈ э ы н ӄ э н я г _ м а _ е _ ч _ ч о н э р э т ч ы г ы т
ынӄэн нылгэмаравръоӄэнат чама ръа имыръэнут нинэнпирӄыӄин ынӄэн	ы н ӄ э н н ы г э м а р а в _ р ъ о ӄ э н а т _ ч а м а р ъ а и м ы р ъ э н у т _ н и н э н п _ и р ӄ ыӄин _ ы н ӄ э н _
эгэй ытлён иквъи	э г э й ы т ё н _ и к в ъ и _
итыкъым льэлеӈкыӈэ ныялгынморэ	и т ы к ъ ы м ь э е _ ӈ к ы ӈ э _ н ы я г ы н м о р э
ытръэч ынӄэн лгиинъэ ныгъевмури	ы т р ъ э ч ы н ӄ э н г и и н ъ э _ н ы г ъ е в _ м у р и _
ымы мургинэ ынпыначгынэ ы’вэӄучин тумгытум ы’вэӄучин ытлыгын мык гымыгтумгин ытлыгынэ	ы м ы м у р г и н э ы н п ы н а ч г ы н _ э _ ы ’ в э ӄ у ч и н _ т у м г ы т у м ы ’ в э ӄ у ч _ и н ы т _ ы г ы н _ м ы к г ы м ы г _ т у м г и н ы т _ ы г _ ы н э
моргынан нынлеӄоно нинъэйӈэвмури	м о р г ы н а н н ы н е ӄ о н _ о _ н и н ъ э й ӈ э в м у р и
ынпыначгын	ы н п ы н а ч г ы н
ынӄэн нинэныгъевмури ымы ӈинӄэгти ымы ныӄамэтвачайоморэ инъэ лгиинъэӄэй	ы н ӄ э н н и н э н ы г ъ е в м у р и _ ы м ы _ ӈ и н ӄ э г т и ы м ы н ы ӄ а м э т в а _ ч а й _ о м о р э _ и н ъ э _ г и и н ъ э ӄ э й _
ӄорыӈэ ныръэйвэнмури яраӈы	ӄ о р ы ӈ э н ы р ъ э й в _ э н м у р и я р а ӈ ы _
нырэтэмӈытэнмури ымыльэты ынӄэнэ	н ы р э т э м ӈ ы т э н м у р и ы м ы _ ь э т ы ы н ӄ э н э _
ынӄоры ӄлявылтэ норвынпэтгавӄэнатъым	ы н ӄ о р ы ӄ я в ы т _ э _ н о р в ы н п э т г а в _ ӄэнат ъ ы м
ынӄэн виин рыюльынэ рыюльэ виин ынӄэнэ ӄаагтынолгынэ нинэ нинэныпкирэтӄинъым	ы н ӄ э н в и и н р ы ю ь _ ы н э _ р ы ю _ ь э в и и н ы н ӄ э н _ э ӄ а а г т _ ы н о _ г ы н э _ н и н э н и н э н ы п к и р э т ӄ и н _ ъ ы м
тэкэм инъэъымэ ӄэлюӄы’м нычайпанморэ чамаъым ынӄэнэ эръэт нэмыӄэй амрачайоӈа	т э к э м и н ъ э ъ ы м э _ ӄ э ю _ ӄ ы ’ м н ы ч _ а й п а н м о р э ч а м а _ ъ ы м ы н ӄ э н э _ э р ъ э т н э м ы ӄ э й _ а м р а ч _ а й _ о ӈ _ а
ынӄэнэ ӄаагтынолгын эмрэнъылиӈэ энэӄылпэ нычайоморэ ынан ӈинӄэгти нэнанӄамэтвавморэ ынӄоры ӈэлвыл нинэнъылимури	ы н ӄ э н э ӄ а а г т ы н о _ г ы н э м р э н _ ъ ы и ӈ э _ э н э ӄ ы п э н ы ч _ а й о м о р э ы н а н _ ӈ и н ӄ э г т и н э н а н ӄ а м э т в а в _ м о р э _ ы н ӄ о р ы _ ӈ э в ы н и н э н _ ъ _ ы и м у р и _
ныӄор ныӄорагыркэморэ ӈэвэӄ	н ы ӄ о р н ы ӄ о р _ а г ы р к _ э м о р э ӈ э в э ӄ
ымыӈэ гым тумгынэ нинивӄин	ы м ы ӈ э г ы м т у м г ы н _ э н и н и в ӄ и н _
э’птэ ӄыӄорагыркэ ӄыӄорагыркэркын ынӄэн ӄинэвинрэтыркын	э ’ п т э ӄ ы ӄ о р а г ы р к э _ ӄ ы ӄ _ о р а г ы р к _ э р к ы н ы н ӄ э н ӄ и н э в и н р э т ы р к ы н
ынпыӈэвытъым ӄэлюӄы’мэ ынӄэн нэмыӄэе	ы н п ы ӈ э в ы т ъ ы м ӄ э ю ӄ ы _ ’ м э _ ы н ӄ э н н э м ы ӄ э е
ӈоонӄоӈэ мэӈӄо поӄэпы нэнанӈытоӈанморэ	ӈ о о н ӄ о ӈ э м э ӈ ӄ о п _ о ӄ э п ы _ н э н а н _ ӈ ы т о ӈ а н м о р э _
гым тэӈэмпиритэ ынӄэнэ рырвинрыёт чеймыкинэт ынӄэнат гымнан а’тав нэнайпатэвым	г ы м т э ӈ э м п и р и т э _ ы н ӄ э н _ э р ы р в и н р ы ё т _ ч е й _ м ы к и н э т _ ы н ӄ э н а т г ы м н а н а ’ т а в н э н _ а й п а т _ э в _ ы м _
ытлёнъым эӄылпэ ӈэвэӄэ еп айвэ титэ ы’ттъыёле ынӄэн раёвынвыл раёвынвылӄылтэӈэ ынпыначгаӈэ нэнаёпат нинэлӄырирӄинэтъым	ы т ё н ъ ы м _ э ӄ ы п э ӈ э в э ӄ э _ е п а й в э _ т и т э ы ’ т т ъ _ ы ё _ е _ ы н ӄ э н _ р а ё в ы н в ы р а ё _ в ы н _ в ы ӄ _ ы т э ӈ э ы н п ы н а ч г а ӈ э н э н а ё п а т н и н э ӄ _ ы р и р ӄ и н э т _ ъ ы м _
нырэювмури ынӄэнэ ныӄаавъянморэ	н ы р э ю в м у р и _ ы н ӄ э н э н ы ӄ а а в _ ъ я н м о р э _
гымнанэ ӄэлюӄ рырвинрыёт кааръаматыльыт чеймыкинэт нинэт нэнавъятэвым итык чама	г ы м н а н э ӄ э ю ӄ _ р ы р в и н р ы ё т _ к а а р ъ а м _ а т ы ь _ ы т ч е й м ы к и н э т _ н и н э т н э н а в ъ я т э в _ ы м _ и т ы к ч а м а
чымӄыкъым эты тумгэ ы’вэӄучитэ нэнайпа нэнавъятӄэнат	ч ы м ӄ ы к ъ ы м э т ы т у м г э _ ы ’ в э ӄ у ч и т э н э н а й п _ а _ н э н а в _ ъят _ ӄ э н а т
ӈэвъэн	ӈ э в ъ э н
нытарагморэ мури гэтумгинэтэ ӈинӄэгти виинэ ӄоо миӈкы лымынӄо нылейвыӄинэт	н ы т а р а г м о р э _ м у р и г э т у м г и н э т э _ ӈ и н ӄ э г т и _ в и и н э _ ӄ о о _ м и ӈ к ы ы м ы н ӄ о _ н ы е _ й в ы ӄ и н э т _
нытарагморэ нытарогморэ	н ы т а р а г м о р э _ н ы т а р о г м о р э _
юргаюкъыма ӄол итгъи ынӄэна чыӈатэнмычыкоеквэ нылеӄинъым	ю р г а ю к _ ъ ы м а ӄ о и т г ъ и ы н ӄ э н а _ ч ы ӈ а т _ э н м _ ы ч ы к о е к в э _ н ы е ӄ и н ъ ы м
люут э’ӄэльэӈа танӈа ӈалгылёӈа натагъан нэйпыгъэн ръэт	ю ут э ’ ӄ э _ ь э ӈ а _ т а н ӈ а ӈ а г ы ё _ ӈ а _ н а т а г ъ а н н э й п ы _ г ъ э н р ъ э т _
и’ӈыт чвининэтъыма	и ’ ӈ ы т ч в _ и н и н э т ъ ы м а _
янратъэчгына ӈачгытъэлгык ӈач ӈачгыӈкы э’левнинъымэ	я н р а т ъ э ч г ы н _ а ӈ а ч г ы т ъ э г ы к _ ӈ а ч ӈ а ч г ы ӈ к ы э ’ _ е в _ н и н ъ ы м _ э
и’лгын мраӈӄа гакаӈӄорэн мраӈэ’ӈыкъым	и ’ г ы н м р а ӈ ӄ _ а г а к а ӈ ӄ о р _ э н м р а ӈ _ э ’ ӈ ы к _ ъ ы м
мыльурэгъи ынкы наӄам пиӈэтчыӈын лыгэныввалявнэн	м ы ь у р э г ъ и _ ы н к ы н а ӄ а м п и ӈ эт _ ч ы ӈ ы н _ _ ы г э н ы в в а _ я в н э н
тэӈэвыт лыгэнывваляв чама рыввиръувнинъым	т э ӈ э в ы т ы г э н _ ы в в а _ я в ч а м а р ы в в и р ъ _ у в н и н _ ъ ы м
нынъувэвытылеӄин э’ӄэльэ’м	н ы н ъ у в э в ы т ы е _ ӄ и н э ’ ӄ э ь э ’ м _
нэгитэгъэн эвына выегалягъэ въялгалягъэ эвына	н э г и т э г ъ э н эвын а в ы е _ г а _ я г ъ э _ в ъ я г а я _ г ъ э э в ы н а
энмыткынык напэӄовтытэвляӄэн	э н м ы т к ы н ы к н а п э ӄ о в т ы т _ э в _ я ӄ э н
ытръэч	ы т р ъ э ч
энмэн гатвален кальайӈын ынкъам пчеӄалгын	э н м э н г а т в а е н к а _ ь _ а й ӈ ы н ы н к ъ а м _ п ч е ӄ а _ г ы н _
льувылгыгъэт	ь у в ы г ы г ъ э т _
иквъэт ги мынӄымлёченмык	и к в ъ э т г и м ы н ӄ ы м _ ё ч е н _ м ы к _
кальайӈын эгэ мынӄымлёченмэв	к а ь а й ӈ ы н э _ г э м ы н ӄ ы м _ ё ч е н м э в _
кальайӈын янот гым мӄымлёчетык	к а ь а й ӈ ы н я н о т _ г ы м м ӄ ы м _ ё _ ч е т ы к _
пчеӄалгын иквъи эгэ евъев	п ч е ӄ а г ы н _ и к в ъ и э г э е в ъ е в _
оонъылгыӄай пиринин	о о н ъ ы г ы ӄ а й п и р и н и н _
энаркэынэн гыткалгыӄай	э н а р к э ы н э н г ы т к _ а г ы ӄ а й
выквылгыйӈын пиринин кальайӈа	в ы к в ы г ы й ӈ ы н п и р и н и н к а _ ь а й ӈ а _
чит ӄымлёркынэн пчеӄалгыӄай	ч и т ӄ ы м ё р к ы н э н _ п _ ч е ӄ а г ы ӄ а й _
пчеӄалгыӄайа гыткалгын гэнрултэтлин	п ч е ӄ а г ы ӄ а й _ а г ы т к а г ы н г э н р _ у т э т _ и н
оонъылгын гэтриллин	о о н ъ ы г ы н г э т р и _ и н
эв ии рыпэт чыпъэв	э в и и р ы п э т ч _ ы п _ ъ э в _
ытръэч	ы т р ъ э ч
ӄол титгъэк тынотапынмынтагъакъым	ӄ о т и т г ъ э к т ы н о т _ а п ы н м _ ы н т а г ъ а к _ ъ ы м
клюпыӈӄачагты тычейвыткугъакъым	к ю п ы ӈ ӄ а ч а г т ы _ т ы ч е й в ы т к у г ъ а к ъ ы м _
ынкы клюпык ӄача ӄычекытвальымкына тыйъоа’нъым тымӈылёнат	ы н к ы к ю п ы к _ ӄ а ч а _ ӄ ы ч е к ы т в а ь _ ы м к ы н _ а т ы й ъ о а ’ н ъ ы м _ т ы м ӈ ы ё н а т
ныръэтури	н ы р ъ э т у р и
иквъи амвынэ камчамолтэ нумэкэтӄинэт	и к в ъ и а м в ы н э _ к а м _ ч а м о т _ э н у м э к э т ӄ и н э т
ээ микынти’м камчамолтэ	э э м и к ы н т и ’ м к а м _ ч _ а м о т _ э
ынӄэнъымэ тагмэгчетъянвытъым ӈэнъянвыт	ы н ӄ э н ъ ы м э т а г _ м э г ч е т _ ъ я н в ы т ъ ы м ӈ э н ъ я н в ы т
ээ эты гым камчамолевым	э э э т ы г ы м к а м _ ч _ а м _ о _ е в ы м
иквъэтэ амвынэ гыт эвнумэкэткэ	и к в ъ э т э а м в _ ы н э г ы т _ э в н у м э к эткэ _
ээ эвыӈан ӄырымэнайгым камчамолевым	э э э в ы ӈ а н ӄ ы р ы м э н а й г ы м к а м _ ч _ а м _ о _ е в ы м
трагтыгъак	т р а г т ы гъак
ӈуткэкин омваамвыкэн тымӈэлӄот нымӈылтэлӄэн	ӈ у т к э к и н о м в а а м в ы к э н _ т ы м ӈ э ӄ _ о т н ы м ӈ ы т э ӄ э н _
ӄол титгъэк тынотапынмынтагъакъым	ӄ о т и т г ъ э к т ы н о т _ а п ы н м _ ы н т а г ъ а к _ ъ ы м
клюпыӈӄачагты тычейвыткугъэк	к ю п ы ӈ ӄ а ч а г т ы _ т ы ч е й в ы т к у г ъ э к
ынкы ӄычекытвальымкына	ы н к ы ӄ ы ч е к ы т в а ь _ ы м к ы н _ а
тыйъоа’н тымӈылёнат ныръэтури	т ы й ъ о а ’ н т ы м ӈ _ ы ё н а т н ы р ъ э т у р и _
иквъэт вынэ вай камчамолтэ нумэкэтӄинэт	и к в ъ э т в ы н э в а й к а м _ ч _ а м _ о т _ э н у м э к э т ӄ и н э т
ээ эты вай гым камчамолевым	э э э т ы в а й г ы м _ к а м _ ч _ а м _ о _ е в ы м
вы гыт ынӈин эвнумэкэткэ	в ы г ы т ы н ӈ и н э в н _ у м э к _ эткэ _
ээ микынти’м камчамолтэ	э э м и к ы н т и ’ м к а м _ ч _ а м о т _ э
ынӄэнъыма ӈэнъянвытъым тагмэгчеръянвыт	ы н ӄ э н ъ ы м а ӈ э н ъ я н в ы т ъ ы м _ т а г м э г ч е _ р ъ я н в ы т _
амвынэ трагтыгъак	а м в ы н э т р _ а г т ы гъак
тивымкэ тивык этаны вай ӄырымэнайгым камчамолевым	т и в ы м к э т и в ы к э т а н ы _ в а й ӄ ы р ы м э н а й г ы м _ к а м _ ч _ а м _ о _ е в ы м
омваамвылгэты гэймэвлин катюша катюша	о м в а а м в ы г э т ы _ г э й м э в и н к _ а т ю ш _ а к а т ю ш _ а
гапыгынмасӄэвлен колё катюша катюша	г а п ы г ы н м а с ӄ э в _ е н к о ё к а т _ ю ш _ а к а т ю ш _ а
ынкъам колё нинэнмытӄин	ы н к ъ а м к о ё н и н э н _ м ы т _ ӄ и н
нинэнмытпытӄынмытӄин	н и н э н м ы т п ы т ӄ ы н _ м ы т ӄ и н
таӈванэван нэйитгъэн пыгпыг ӈан пыгпыг ӈан	т а ӈ в а н э в а н н э й и т г ъ э н п ы г п ы г _ ӈ а н _ п ы г п ы г ӈ а н _
тэлеӈкы гатвален о’равэтльан	т э е ӈ к ы г а т в а _ е н о ’ р а в э т _ ь а н
ныӄааркываляркыляӄэн	н ы ӄ а а р к ы в а _ я р к ы я ӄ э н
люут элгаро эрэтгъи	ю ут э г а р _ о э р э т г ъ и _
ынӈин льэлеӈитгъи ӈэргэргитгъи льэлеӈитгъи	ы н ӈ и н ь э е ӈ и т _ г ъ и _ ӈ э р г э р г и т г ъ и ь _ э е ӈ и т г ъ и _
кыткытык ылвылютэ нинивӄин	к ы т к ы т ы к ы в ы ю т э _ н и н и в ӄ и н _
мэсӄымавыч мэсӄымэк гииӈитгъи	м э с ӄ ы м а в ы ч _ м э с ӄ ы м э к г и _ и ӈ и т г ъ и
ӈинӄэй ӈээккэӄэй ӄынрагтатгынат	ӈ и н ӄ э й ӈ э э к к э ӄ э й ӄ ы н р а г т а т г ы н а т _
ӈинӄэй кэйӈывилюну ӄытэнынныӈгын	ӈ и н ӄ э й к э й ӈ ы в и _ ю _ н у ӄ ы т э н ы н н ы ӈ г ы н
ӈээккэӄэй ӈээккэӄэй нут нутэӈэвытыну	ӈ э э к к э ӄ э й ӈ э э к к э ӄ э й н у т н у т э ӈ э в ы т _ ы н у _
ынӄэн яральата энмэч гынин эвиръыт нэнылгывэтыркынэт	ы н ӄ э н я р а ь _ а т а _ э н м э ч г ы н и н э в и р ъ ы т н э н _ ы г _ ы в _ э т ы р к ы н э т _
ынӄо ылвылютэ рытрилнин ӄлявыл	ы н ӄ о ы в ы ю т э _ р ы т р _ и н и н ӄ я _ в ы
ыныгрээн ӈинӄэй ӈээккэӄэй	ы н ы г р э э н ӈ и н ӄ э й ӈ э э к к э ӄ э й
наӄам кэйӈывилюльыт	н а ӄ а м к э й ӈ ы в и _ ю _ ь ы т
ылвылютэ ивнин никут	ы в ы ю т э и в н и н _ н и к у т
айвачыӈӄачайпы ӄининиги	а й в а ч ы ӈ ӄ а ч а й п ы ӄ и н и н и г и _
митъэлыги ӈан маёлгын ӄанарайъо йъот’ра нарайъотляты ӄывъёпчагынат	м и т ъ э ы г и ӈ а н м _ а ё г ы н _ ӄ а н _ а р а й ъ о й ъ _ о т ’ р а _ н а р а й ъ о т я _ т ы ӄ ы в ъ ё п ч а г ы н а т _
ангынтавкэгты	а н г ы н т а в к э г т ы
ынӄэн гынинэт эвиръыт нэнылгывэтыркынэт	ы н ӄ э н г ы н и н э т э в и р ъ ы т н э н _ ы г _ ы в _ э т ы р к ы н э т _
айвачыӈкы тагъэ	а й в а ч ы ӈ к ы т а г ъ э
мач гыргочайпы выёпчанэнат	м а ч г ы р г о ч а й п ы в ы ё п ч _ а н э н а т _
эвиръынлельыт яральыт	э в и р ъ ы н е ь ы т _ я р а ь ы т _
нэгитэгъэн нэлкылгъэн	н э г и т э г ъ э н н э к ы г ъ э н
наӄам ыныгрээн ӈиръэ нэнэнэт	н а ӄ а м ы н ы г р э э н ӈ и р ъ э н э н э н э т _
эвын ӄымэк гынтэквъэтъым	э в ы н ӄ ы м э к г ы н т э к в ъ э т ъ ы м _
ынан ивнинэт	ы н а н и в н и н э т
ынӄэнэ ынӄэнайгым	ы н ӄ э н э ы н ӄ э н а й г ы м
ванэ гым мраквачак	в а н э г ы м м р а к _ в а ч _ а к _
ӈотӄэнат гымнинэт нэнэнэт	ӈ о т ӄ э н а т г ы м н и н э т н э н э н э т
ынӄо ӈинӄэй ӈээккэӄэй нутэӈэвыт	ы н ӄ о ӈ и н ӄ э й ӈ э э к к э ӄ э й н у т э ӈ э в ы т _
йъарат накапчачгэтагъан ынӄо лгэкоргаквъат	й ъ а р а т н а к а п ч а ч г э т _ а г ъ а н _ ы н ӄ о г э к о р г а к в ъ а т _
лгэкоргаквъатъым нанрагтатынат	г э к о р г а к в ъ а т ъ ы м _ н а н р а г т а т ы н а т
ынкъамэ ӄаӈан микынти игыт яатльат тынтыяатынат	ы н к ъ а м э ӄ а ӈ а н _ м и к ы н т и и г ы т _ я а т ь _ а т _ т ы н _ т ы я а т ы н а т
кымгытчитгъи кымъылгыӄэй	к ы м г ы т ч и т г ъ и к ы м ъ _ ы г ы ӄ э й
ӄольым нэмэ ынык ӄача	ӄ о ь ы м н э м э _ ы н ы к ӄ а ч а
кымъырултын кымъытэгын кымгытчитгъэт мимлытэгнык	к ы м ъ ы р у т ы н _ к ы м ъ ы т э г ы н к ы м г ы т ч и т _ г ъ э т м и м _ ы т э г н ы к
уттыӄэйэ мывинрэтгъэк юръэ йигрэ кымгытчитгъэт	у т т ы ӄ э й э м ы в и н р э т г ъ э к _ ю р ъ _ э й и г р э _ к ы м г ы т ч и т г ъ э т _
гытэӈпылытъымкытгынтыйъакытгынтыпалина	г ы т э ӈ п ы ы т ъ ы м _ к ы т г ы н т ы й ъ а к ы т г ы н т ы п а и н а
гытэӈйъапылытъымкытгынтыпалина	г ы т э ӈ й ъ а _ п ы ы т ъ ы м к ы т г ы н т ы п а и н а
гытэӈйъапылытъымкытгынтыарина	г ы т э ӈ й ъ а _ п ы ы т ъ ы м к ы т г ы н т ы а р и н а
нӄэнэ ымыӈ нытваӄэнэ ынӄэнэ ӈинӄэй а’ачеӄӄай ӈэлвыльыкыӈа	н ӄ э н э ы м ы ӈ _ н ы т в а ӄ э н э ы н ӄ э н _ э _ ӈ и н ӄ э й а ’ а ч е ӄ ӄ а й _ ӈ э в ы _ ь _ ы к _ ы ӈ а
гытгак а’йӈама тыр тыркыльэ тыркыльэ ӄора ӄоратыр тыркыльэ гаегъентолен	г ы т г а к а ’ й ӈ а м а _ т ы р _ т ы р к ы ь э _ т ы р _ к ы ь э ӄ о р а _ ӄ о р а т ы р т ы р _ к ы _ ь э г а е _ г ъ е н т о е н _
йъэ гытга рынна гагтоленат	й ъ э г ы т г а _ р ы н н а г а г т о _ е н а т _
ынӄэн гатвален ынӈин пыӈыл тит тэленъеп	ы н ӄ э н г а т в а е н ы н ӈ и н _ п ы ӈ _ ы т и т _ т _ э е н ъ е п _
ӄытлыги рэнрильилгынэ гапанрэватлен ынӄэнэ	ӄ ы т ы г и р э н р и _ ь и г ы н _ э г а п а н р э в а т _ е н ы н ӄ э н э
э’рыкут гым ым мэм мэмлетыӈэ трэӄыгъэк	э ’ р ы к у т г ы м ы м м э м _ м э м _ е т _ ы ӈ э _ т р _ э ӄ ы г ъ э к
читъым читъым э’квырга пэлг пэлгытагнэты мимлечы тымимлычыкутгъэк	ч и т ъ ы м ч и т ъ ы м _ э ’ к в _ ырга п э г _ п э г ы т а г н э т ы _ м и м _ е ч ы _ т ы м и м ы ч ы к у т _ г ъ э к
тэлиӈ тэ тъаӄалеӈӈытоа’къым	т э и ӈ т _ э т ъ а ӄ _ а е ӈ _ ӈ ы т о а ’ к ъ ы м
ӄытлыги ынӄэ лёльолгын ранрэльэлгэпы гэпинтыӄэтлин	ӄ ы т ы г и ы н ӄ э _ ё ь о _ г ы н р а н _ р э ь э г _ э п ы г э п и н т ы ӄ э т и н
ӄы ӈоонко ӈинӄэгти нивӄинэт	ӄ ы ӈ о о н к о ӈ и н ӄ э г т и _ н и в ӄ и н э т
ыммэмэй эӄылпэ ынӄэн ръэнут ынӄэ гынин у’рэквъи	ы м м э м э й э ӄ ы п э ы н ӄ э н _ р ъ э н у т _ ы н ӄ э _ г ы н и н _ у ’ р э к в ъ и _
ванэван мычичевнэт	в а н э в а н м ы ч и ч е в н э т _
тынарагтын нэмыӄэй нивӄин	т ы н а р а г т ы н н э м ы ӄ э й _ н и в ӄ и н
ынӄэнэ ӄытэнкэвӈыгын	ы н ӄ э н э ӄ ы т э н к э в _ ӈ ы г ы н _
ръэнут	р ъ э н у т
танӈыӈавӄай ӈутку иквъи	т а н ӈ ы ӈ а в ӄ а й ӈ у т к у и к в ъ и _
ынӄэнэ рэнрильилгын ӄытэнкэвӈыгын	ы н ӄ э н э р э н р и _ ь и г ы н _ ӄ ы т э н к э в ӈ ы г ы н _
тыгитээ’н ӈоон ынӄэн	т ы г и т э э ’ н ӈ о о н _ ы н ӄ э н
лёльолгын гэпинтыӄэтлин нивигым ын тэӈынӈин	ё ь о г ы н г э п и н т ы ӄ _ э т и н н и в и г ы м _ ы н т э ӈ ы н ӈ и н
ӄун ынпычьэккэтэ тынтоа’к мытэ мытъабэтчыӄэвмык ынпычьэккэтэ нинивӄин	ӄ у н ы н п ы ч ь э к к э т э т ы н т о _ а ’ к _ м ы т _ э м ы т ъ _ а б э т _ ч ы ӄ э в м ы к ы н п ы ч ь э к к э т э н и н и в ӄ и н
лыгэн мама ынӈин вальын ымыльорыкы нэл нэнанкалровӄэн	ы г э н м а м а _ ы н ӈ и н в а _ ь ы н ы м ы _ ь _ о р ы к ы _ н э н э н а н к _ а р о в ӄ э н _
ӄэлюӄы’м тэнӈу мытытчыгъэн лыгэн лёльолгын пинтыӄэтыльын ынӄэнэ ранрэльэлгычыкойпы	ӄ э ю ӄ ы ’ м т э н ӈ у _ м ы т ы т ч ы г ъ э н _ _ ы г э н ё ь о _ г ы н п и н т ы ӄ _ э т ы ь ы н ы н ӄ э н _ э р а н р э _ ь э г _ ы ч ы к о й п ы
мама лыгэн ымыльорыкы нэльуэ’н	м а м а ы г э н _ ы м ы ь _ о р ы к ы _ н э ь у _ э ’ н
наӄам ванэ никвъэн ръэнут нэльуэ’н	н а ӄ а м в а н э н и к в ъ э н р ъ э н у т _ н _ э _ ь _ у _ э ’ н
гэгэргыпынчилин ӄэлюӄэ чама юрэӄы’м ынӄэнэ ӈыркылятгъэ	г э г э р г ы п ын ч и и н _ ӄ э ю ӄ э ч а м а ю р э ӄ _ ы ’ м _ ы н ӄ э н _ э ӈ ы р к ы я _ т г ъ э
гатваленат ӈиръэ ӈэвъэнйыръын	г а т в а е н а т ӈ и р ъ э _ ӈ э в ъ э н й ы р ъ ы н
ӄол ковлёвльольынъым ӄоле ивлыльулӄылльын	ӄ о к о в ё в _ ь о _ ь ы н ъ ы м ӄ о е и в ы _ ь у ӄ _ ы ь ы н
ынкъам гъэтйивлинэт	ы н к ъ а м г ъ э т й и в _ и н э т _
ӄол ни нинивӄин	ӄ о н и н и н и в ӄ и н _
гынин льулӄыл ӄнут кокатчетъёлгын	г ы н и н ь у ӄ ы _ ӄ _ н у т к о к а т ч _ е т ъ ё _ г ы н
ӄольым иквъи	ӄ о ь ы м и к в ъ и _
гынинъым ӄнут рэпалӄыёлгын	г ы н и н ъ ы м ӄ н у т _ р э п а ӄ _ ы ё г ы н
миӈкэтэ лымэвыт ваамъеквэъым лымэвыт аӈӄаеквэ нылеӄин магляльынъым	м и ӈ к э т э ы м э в ы т в а а м ъ е к в э _ ъ ы м _ ы м э в ы т _ а ӈ ӄ а е к в э н ы е _ ӄ и н м _ а г _ я ь ы н _ ъ ы м
люут льунинэ элгъоравэтльан	ю ут ь у н и н _ э э г ъ _ о р а в э т ь а н _
йыӈэнинъым ченэтрагты танэн ынкыӈэ	й ы ӈ э н и н ъ ы м ч е н э т р а г т ы т а н э н _ ы н к ы ӈ э _
выткуӈэ чыкээквъиы’мэ	в ы т к у ӈ э ч ы к э э к в ъ и ы _ ’ м э _
пэнъёлгыткоӄэн ръэнут эты эчкимоч леӈытаӄ	п э н ъ ё г ы т к о ӄ э н _ р ъ э н у т э т ы э ч к и м _ о ч _ е _ ӈ ы т а ӄ
ынкы нэнаномаватӄэн	ы н к ы н э н а н о м а в а т ӄ э н _
нинэгитэӄин ръэмиӈкэкин ӈотӄэн о’равэтльан	н и н э г и т э ӄ и н р ъ э м и ӈ к э к и н _ ӈ о т ӄ э н _ о ’ р а в э т ь а н _
игыт марэгына манэгран нанкалыроквъан уттынутэкэнэ чамаӈа ваамлыӈкы вальын	и г ы т м а р э г ы н а _ м а н э г р а н _ н а н к а ы р _ о _ к в ъ а н у т т ы н у т э к э н э ч а м _ а ӈ а в а а м ы ӈ к ы _ в а ь ы н _
валӄылыргытанӈын тинлылельынэ	в а ӄ ы ы р г ы т а н _ ӈ ы н т и н ы е ь ы н э _
ынӄэнэ ръэнут нинэтэйкыӄин кэликэл юрэӄы’мэ	ы н ӄ э н э р ъ э н у т н и н э т э й к ы ӄ и н _ к э и к э _ ю р э ӄ _ ы _ ’ м э _
ӈаргыночьыт нинэтэнгыеӈӄээт миӈкыри вальыт	ӈ а р г ы н о ч ь ы т н и н э т _ э н г ы е ӈ ӄ э _ э т м и ӈ к ы р и в а ь ы т _
вытку льунин ынӄэн игыт	в ы т к у ь у н и н ы н ӄ э н _ и г ы т _
ытръэч	ы т р ъ э ч
и’ныӈэ энмэна эн ынӄэн и’ны мэльыттъывытрынэ ӄынут гэгиинрэлин ӄынутэ гытъэвыльын гэймэвлин о’равэтльак	и ’ н ы ӈ э э н м э н а _ э н ы н ӄ э н _ и ’ н ы м э _ ь _ ы т т ъ _ ы в ы т р _ ы н э ӄ ы н у т г э г и и н р э _ и н _ ӄ ы н у т э г ы т ъ э в ы _ ь ы н г э й _ м э в и н о ’ р _ а в э т ь а к
ытръэч	ы т р ъ э ч
ӄонпы нывичвэтчыӄивӄинэтъым ныманэванлясӄэвӄэнат	ӄ о н п ы н ы в и ч в э т ч ы ӄ _ и в ӄ и н э т _ ъ ы м н ы м а н э в а н я _ с ӄ э в ӄ э н а т
ӄынвэт иран ирана нинэльуӄин чиниткин экыкv эймэвыльын ыныкагты’м	ӄ ы н в э т и р а н и р _ а н а _ н и н э _ ь у ӄ и н _ ч и н и т к и н э к ы к э й м э в ы _ ь ы н _ ы н ы к а г т ы _ ’ м
нъыръыйылӄыӈӈоӄэн ынӈин вай	н ъ ы р ъ ы й ы ӄ ы ӈ ӈ о ӄ э н ы н ӈ и н _ в а й
эккэтэ’м ынӈин ынӄэн нинэгитэӄинъым	э к к э т э ’ м ы н ӈ и н ы н ӄ э н _ н и н э г и т э ӄ и н ъ ы м _
ӄынвэт ӄынвэт нытанӈыткоӈӈоӄэн	ӄ ы н в э т ӄ ы н в э т н ы т а н ӈ ы т к о _ ӈ ӈ о ӄ э н _
ыммэмы ӄэнаманэлпынрыгэ	ы м м э м ы ӄ э н а м _ а н э п _ ы н р ы г э
ынкы ӄээӄынъым мывичвысӄиквъэк	ы н к ы ӄ э э ӄ ы н ъ ы м м ы в _ и ч в _ ы с ӄ и к в ъ э к _
эээ ӄэлюӄы’м нэнаманэлпынрыӄэн	э э э ӄ э ю ӄ ы _ ’ м н э н а м _ а н э п ы н р _ ы ӄ э н
мургинэт нэмыӄэй ныетӄинэт ӈинӄэгти	м у р г и н э т н э м ы ӄ э й н ы е т ӄинэт _ ӈ и н ӄ э г т и _
нэмыӄэй ныманэванлясӄэвӄэнат	н э м ы ӄ э й н ы м а н э в а н _ я _ с ӄ э в ӄ э н а т
э’тки вай ӄээӄын мытылгирывичвэнӈыркын	э ’ т к и в а й ӄ э э ӄ ы н м ы т _ ы г _ и р _ ы в и ч в _ э н ӈ ы р к ы н
ӄэлюӄы’м ытлыгэ нэнаманэлпынрыӄэнатэ амъянра наӄам	ӄ э ю ӄ ы ’ м ы т _ ы г э н э н а м а н _ э п ы н р _ ы ӄ э н а т э а м ъ я н р а н а ӄ а м
ынӈинъымэ	ы н ӈ и н ъ ы м э
нэмэ ын нэмэ ынӄэн ӈыро комната ныйъоӄэн	н э м э ы н н э м э ы н ӄ э н _ ӈ ы р _ о _ к о м _ н _ а т а н ы й ъ о ӄ э н _
ынпыӈэвӄэй кымъыӈэӄэйъымэ летынтагравнэн ытльаӄай лгитэленъепкинэ лыгэн лгиынпыӈэвӄэй аръаля	ы н п ы ӈ э в ӄ э й к ы м ъ ы ӈ э ӄ э й _ ъ ы м _ э е т ы н т а г р а в н э н _ ы т ь а ӄ а й г _ и т э е н ъ е п к и н _ э ы г э н г и ы н п _ ы ӈ э в ӄ э й _ а р ъ а я
купрэткумуриӈэ ямгагытгыкъым рээн ӈоонӄо ваӈӄарэмак ӄача кынмаӈӄакъым	к у п р э т к у м у р и ӈ э _ я м г а г ы т _ г ы к ъ ы м р э э н ӈ о о н ӄ о в а ӈ ӄ а р _ э м _ а к _ ӄача к ы н м а ӈ ӄ а к ъ ы м _
нэкэм вай ынӄоӈэ ваӈӄарэмараӄаеквэйпыӈэ таӈо’ра выквыткойӈыт ынӈин вэтляквыткойӈыт вальытъымэ	н э к э м в а й ы н ӄ о ӈ э _ в а ӈ ӄ _ а р _ э м а р а ӄ _ а е к в э й п ы ӈ э т а ӈ о ’ р а в ы к в _ ы т к о й ӈ ы т ы н ӈ и н _ в э т я к в _ ы т к о й _ ӈ ы т в а ь ы т ъ ы м э _
нивӄинэ	н и в ӄ и н э
ӈанӄаатъым ӄынут ӈанэ ӄытлыги тэленъепэ тылельытэ миӈкы имлетгынтэвыльыт ӄэлюӄы’мэ ӈанӄэ чит таӈымыльэтыӈа ӈотӄэн нутэнут мургин мимлычыку вальын	ӈ а н ӄ а а т ъ ы м ӄ ы н у т _ ӈ а н э ӄ ы т _ ы г и _ т э _ е н ъ е _ п э т ы е ь ы т _ э м и ӈ к ы и м е т г ы н т э в _ ы _ ь ы т ӄ э ю ӄ ы ’ м э _ ӈ а н ӄ э ч и т т а ӈ ы м _ ы ь _ э т ы ӈ _ а ӈ о т ӄ э н н у т э н у т м у р г и н м и м _ ы ч ы к у _ в а _ ь ы н _
ынкъамэ ынӄэна	ы н к ъ а м э ы н ӄ э н а _
ынӄэна	ы н ӄ э н а
ынкы имлетыкъыма чит ӈутку мургынутэ вальыт камагӈалвыльыйӈытъыма	ы н к ы и м е т ы к ъ ы м а _ ч и т _ ӈ у т к у м у р г ы н _ у т э _ в а _ ь ы т к а м _ а г ӈ а в ы _ ь ы й ӈ ы т ъ ы м а
игыт ӈан рынныт ынӄаатэ нутэкэ ръылӄычыку ръылӄывээмык рээн ныльуӄинэтэ	и г ы т ӈ а н р ы н н ы т ы н _ ӄ а а т _ э _ н у т э к _ э р ъ ы ӄ _ ы ч ы к у р ъ _ ы ӄ ы в э э м _ ы к р э э н н ы ь у ӄ и н э т _ э _
чит нымкыӄин колё камагтэ	ч и т н ы м к ы ӄ и н к о ё _ к а м _ а г т э _
ынкъамэ ынӄэнатаӈа энмэна о’равэт о’ о’равэтрамкына гэегтэллин энмэна	ы н к ъ а м э ы н ӄ э н а т а ӈ а _ э н м э н а _ о ’ р а в э т _ о ’ о ’ р _ а в э т р а м _ к ы н а _ г э е г т э и н _ э н м э н а
ӄол мыгнэнэнэльынъымэ мэйӈынэнэнэтэӈ нэнатратӄэн аӈӄы нэналпынрыӄэнъымэ	ӄ о м ы г н э н э н э _ ь ы н _ ъ ы м э м э й ӈ ы н э н э н э т э ӈ _ н э н а т р а т ӄ э н а ӈ ӄ ы _ н э н а п ы н р ы ӄ э н _ ъ ы м _ э
амынан рыгнуннин нанӈэнчьан нэнэныӈ	а м ы н а н р ы г н у н _ н и н _ н а н ӈ э н ч ь а н н э н э н ы ӈ _
къама мимлык нэмэ пэлӄынтэттылеъи’м къам иултиӈэгчыкыквальынэ ръэвинэ ы’мйиквин ынӄэнэ амылӄыквальын ынкы гамылӄыпэлятлена ръэв	к ъ а м а м и м _ ы к н э м э п _ э ӄ ы н т _ э т _ т ы е ъ и ’ м к ъ а м и у т _ и ӈ э г ч _ ы к ы к в а ь ы н э р ъ э в и н э ы ’ м й и к в и н _ ы н ӄ э н э _ а м ы ӄ _ ы к в а ь ы н _ ы н к ы г а м ы ӄ ы п э _ я т _ е н а р ъ э в
ынӄэн нэмэ мимыл гэквэтлин гэтэлпылин аӈӄакэн	ы н ӄ э н н э м э м и м ы _ г _ э к в э т _ и н г _ э т э п ы и н _ а ӈ ӄ а к э н
льэлеӈръукэ тэкэм ӄуульэтык ӈутри наймыӄаат энмыгэӈэтыӈа	ь э е ӈ р ъ у _ кэ т э к э м ӄ у у ь э т ы к _ ӈ у т р и _ н а й м ы ӄ а а т э н м _ ы г _ э ӈ э т ы ӈ а _
ковлёрвоор ковлёрвыткольын танӈынотайпы етыльын	к о в ё р в о о р _ к о в ё р в ы т к о ь ы н _ т а н ӈ ы н о т а й п ы е т ы ь ы н _
еп инъыӈӄач гатымӈэвлен тагмынгытчьэты тыликъым	е п и н ъ ы ӈ ӄ а ч г а т ы м ӈ э в _ е н _ т а г м ы н г ы т _ ч ь э т ы т _ ы и к ъ ы м _
люутэ вулӄытвикэ ӈэръамытлыӈчьэты галякэ очочаӈа заатеxника инъэйӈэквъи энавэтгавъёлгыткоэ’ иквъиӈа	ю у т э в у ӄ _ ы т в и к э _ ӈ э р ъ а м ы т ы ӈ ч ь э т ы _ г а я к э о ч о ч а ӈ а _ з а а т _ е н и к а _ и н ъ э й ӈ э к в ъ и э н а в э т г а в ъ ё _ г ы т к о _ э ’ и к в ъ и ӈ а
еп гынмыл инъэ ковлёрвоор гатымӈэвленъыма	е п г ы н м ы и н ъ э _ к о в _ ё р в о _ о р _ г а т ы м ӈ э в е н ъ ы м а
льу нэналвавморэ	ь у н э н а в а в _ м о р э
э’ми таӈтымӈэквъэ	э ’ м и т а ӈ т ы м ӈ э _ к в ъ э _
энмэч волӄытвэӈӈо вулӄытвигъим	э н м э ч в о ӄ ы т в э ӈ ӈ о _ в _ у ӄ ы т в и г ъ и м _
ӄорагынрэтыльыт вэчьыма нъетынэтэ мынъумэкэнмыкъым вэнратынво	ӄ о р а г ы н р э т ы ь _ ы т в э ч ь ы м а н ъ е т ы н _ э т э м ы н ъ _ у м э к э н м ы к ъ ы м _ в э н р а т ы н в о
э’йӈэвыткумури энарэрык	э ’ й ӈ э в ы т к у м у р и э н а р э р ы к
пэтле тылыгавэръэпыгъакъыма	п э т е т ы _ ы г а в _ э р ъ э п ы г ъ а к ъ ы м а
ӄорыӈа э’ми епӈа ӄуттиӈа нъатчаӄаат о’равэтльат	ӄ о р ы ӈ а э ’ м и е п _ ӈ а ӄ у т _ т и ӈ _ а н ъ а т ч _ а ӄ а а т о ’ р _ а в э т ь а т _
мури гэтумгинэтэ ӈуткэтэ мытвинвытэгнэнмык айвачваамлыӈата чама рочгэты	м у р и г э т у м г и н э т э _ ӈ у т _ кэтэ м ы т в и н _ в ы т э г н э н _ м ы к а й в а ч в а а м ы ӈ а т а _ ч а м а р о ч г э т ы
ӄорыӈа вай ынкы рочгатама ваамлыӈата йынрытчигэ йынрыгэӈытко мытвинвытэгнэннэтэ	ӄ о р ы ӈ а в а й ы н к ы _ р о ч г а т _ а м а _ в а а м _ ы ӈ а т а й ы н р _ ы т ч и г э _ й ы н р ы г э ӈ ы т к о м ы т в _ и н в ы т э г н э н _ н э т э
ваам эвычагты элӄылинытык айвачыӈӄач уйӈэ ръэт лёӈръэтатыльын	в а а м э в ы ч а г т ы э ӄ ы _ и н _ ы т ы к _ а й в а ч ы ӈ ӄ а ч у й ӈ э р ъ э т ё _ ӈ _ р ъ э т _ а т ы _ ь ы н
ӈоонрэ лм айгысӄыӈӄачьым лымынкыри галгиръэтатлялен	ӈ о о н р э м а й г ы с ӄ ы ӈ ӄ а ч ь _ ы м _ ы м _ ы н к ы р и г а г и р ъ _ э т а т _ я е н
наӄам ээк нывитъытэлпыӄин	н а ӄ а м э э к н ы в и т _ ъ ы т _ э п ы _ ӄ и н
пэлӄынтэнмык визьдикотетыӈ	п э ӄ ы н т э н м ы к _ в и з ь д _ и к о т е т ы ӈ
энмыгэӈкы нытваӄаат	э н м ы г э ӈ к ы н ы т в а ӄ а а т
гырголягты наакатваӄаат	г ы р г о я г т ы _ н а а к а т в а ӄ а а т _
ныӈыръатваӄаат танӈыта	н ы ӈ ы р ъ а т в а ӄ а а т _ т а н ӈ ы т а
миӈкыри мынинмыкъыма	м и ӈ к ы р и м ы н и н м ы к ъ ы м а
тивын очоча	т и в ы н о ч о ч а
этъопэл ӈоонрэ айгыпы мынлельэнмык	э т ъ о п э ӈ о о н р э а й г ы п ы _ м ы н е _ ь _ э н м ы к _
миӈкы винвыт эвын мытрайъоӈына мытрантымӈэвӈӈоӈын мынкынпыткольатыӈӈомыкъым	м и ӈ к ы в и н в ы т э в ы н м ы т р а й ъ о ӈ ы н _ а _ м ы т р _ а н _ т ы м ӈ э в ӈ ӈ о _ ӈ ы н м ы н к ы н п ы т к о _ ь а т ы ӈ ӈ о м ы к ъ ы м
лгиэ’ӄээ’вкы вальын танӈочочьым тиквъэна	г и э ’ ӄ э э ’ _ в к ы в а ь ы н т а н ӈ о ч _ о ч ь ы м _ т и к в ъ э н а
опопыӈа торгынан чинит ӄэнарэрыркынэтык йыӄӄэй ралмалявӈытык гымнан рэӄын ивык	о п о п ы ӈ а т о р г ы н а н ч и н и т _ ӄ э н а р э р ы р к ы н э т ы к _ й ы ӄ ӄ э й _ р а м _ а я в _ ӈ ы т ы к _ г ы м н а н р э ӄ ы н и в ы к
ӄээӄын авъеткынка вэтчатвагъэм	ӄ э э ӄ ы н а в ъ е т к ы н к а в э т ч а т в а г ъ _ э м _
иквъиы’ма	и к в ъ и ы ’ м а
ынӈин ӄыныгйивэтыркын миӈкыри нылеркын	ы н ӈ и н ӄ ы н ы г й и в э т ы р к ы н _ м и ӈ к ы р и _ н ы е р к ы н
ӄээӄын эвычагты айгыпы ӈэнри ваамъеквэ ӄойвыткыната тарӄойвыткыната мытлельэнмыкъым	ӄ э э ӄ ы н э в ы ч а г т ы а й г ы п ы ӈ э н р и _ в а а м ъ е к в э _ ӄ о й _ в ы т _ к ы н _ а т а _ т а р ӄ о й в ы т к ы н а т а м ы т _ е ь э н м ы к _ ъ ы м
чейвэ тъёпатын каӈкачгыргын	ч е й в э т ъ ё п а т ы н _ к а ӈ _ к а ч г ы р г ы н _
тэнкаӈкачгыргыкъыма туркэӈкэлетэ вээмӄэйчыку ачымъытъымыёлгычыкоеквэ мытляӈӈомыкъым тотръэт мытйъогъан	т э н к а ӈ к а ч _ г ы р г ы к ъ ы м а т у р к э ӈ к э е т э _ в э э м ӄ э й ч ы к у а ч ы м ъ _ ы т ъ ы м ы ё _ г ы ч ы к о е к в э м ы т я ӈ ӈ о м ы к ъ ы м _ т о т р ъ э т м ы т й _ ъ о г ъ а н
ынӄэн лыгэн ръэт мытыркылегъэнъым	ы н ӄ э н ы г э н р ъ э т _ м ы т _ ы р к ы _ е _ г ъ э н ъ ы м
люут ӈэраӄычьэты ныкитэ мытынрынгиивын ковлёрвоор	ю ут ӈ э р а ӄ ы ч ь э т ы н ы к и т э _ м ы т ы н р _ ы н г и и в ы н _ к о в _ ё р в о о р _
наӄам ковлёрвыткольын галгэмытӄыталпыӈӈоленъым	н а ӄ а м к о в ё р в ы т к о _ ь ы н _ г а г э м ы т ӄ ы т _ а п ы ӈ ӈ о е н ъ ы м
ръэнут	р ъ э н у т
вылгыкирзовыйчапокльынъыма эвтэ дžинчыӄонагыльын эвыр тэӈэвытӄэй тэгнъыӄэвъяӈӈогъан ыныки нъымытӄытэлпыгъан гаймаӈэн нъыӄитывъигъэн	в ы г ы к и р _ з о в ы й ч а п о к ь ы н ъ ы м а э в т э д и н _ ч ы ӄ о н _ а г ы ь ы н э в ы р т э ӈ э в ы т ӄ э й _ т э г н _ ъ ы ӄ э в ъ я _ ӈ ӈ о г ъ а н ы н ы к и н ъ ы м ы т _ ӄ ы т э п ы _ г ъ а н г а й м а ӈ э н н ъ ы ӄ и т _ ы в ъ _ и г ъ э н
ытръэч	ы т р ъ э ч
лыгъоравэтльана ӈавтыӈгъэ мачквичкакъым тэгнилгыӄин ӈэвысӄэт	ы г ъ о р а в э т _ ь а н а ӈ а в т ы ӈ г ъ э м а ч к в и ч _ к а к _ ъ ы м т э г н и г ы ӄ и н ӈ э в ы с ӄ э т _
ынӄорыӈа ӄолетъылёӈа нэмэ чукоткагты етгъиы’м	ы н ӄ о р ы ӈ а ӄ о е т _ ъ ы ё _ ӈ а н э м э ч у к о т к а г т ы е т г ъ и _ ы _ ’ м
игыт намӈылёгъан тумгэ	и г ы т н а м ӈ ы ё г ъ а н _ т у м г э _
ы’мто гынин ӈэвъэн миӈкэмил вальын	ы ’ м т о г ы н и н ӈ э в ъ э н м и ӈ к _ э м _ и _ в а _ ь ы н
ии ытлён ынръам черитӄыльуӈэ	и и ы т ё н _ ы н р ъ а м _ ч е р и т ӄ ы ь _ у ӈ э _
ӄонпы нилгытэвӄинэ	ӄ о н п ы н и г ы т э в ӄ и н _ э _
турыгъевкы ынкъам вулӄытвик ӄонпы нилгытэвӄин	т у р ы г ъ е в к ы ы н к ъ а м в у ӄ _ ы т в _ и к _ ӄ о н п ы н и г ы т э в ӄ и н _
ӄэлёӄы’м эмнуӈкы гым гъурэтигымэ	ӄ э ё ӄ ы ’ м _ э м н у ӈ к ы г ы м г ъ у р э т и г ы м _ э _
ытлыгыт ытльат ынӄэнэ нутэвги омрыквытгавыт	ы т ы г ы т ы т ь _ а т ы н ӄ э н _ э н у т э в _ г и о м _ р ы к в ы т г а в _ ы т
нылгиныӈинӄинэ гаккантолен ынпычьын гымнин ынинэльын ынӄэнэ котыгыргинэ иvан	н ы г и н ы ӈ и н _ ӄ и н э г а к к а н т о е н _ ы н п ы ч ь ы н г ы м н и н ы н и н э _ ь ы н _ ы н ӄ э н _ э к о т ы г ы р г _ и н э и _ а н
ынык ч ыныкъым гъэмэтыленъымэ ынпыӈэв гымнинэ нутэӈэвыт	ы н ы к ч ы н ы к ъ ы м _ г _ ъ э м _ э т ы е н _ ъ ы м э ы н п ы ӈ э в г ы м н и н э н у т э ӈ э в ы т _
ынӄэнэ челг гачелгыръоленат гатъылыӈӈоленат	ы н ӄ э н э ч е г г а ч е _ г ы р ъ о е н _ а т _ г а т ъ ы ы ӈ ӈ о _ е н а т
ынӄэн уйӈэ гэнъэллин гагалята алымы ӈавкэтльан	ы н ӄ э н у й ӈ э г э н ъ э _ и н _ г а г _ а я т а а _ ы м ы ӈ а в _ к э т ь а н
гымыкэ гымыкъымэ яачыкэнатэ	г ы м ы к э г ы м ы к ъ ы м _ э я а ч _ ы к э н а т э _
вытгытчьэн нэмыӄэйэ ӈээккэӄэй нэмыӄэйэ гагалялен	в ы т г ы т ч ь э н н э м ы ӄ э й _ э ӈ э э к к э ӄ э й н э м ы ӄ э й _ э г а г _ а я _ е н
ынӄоры о’мрыӈа нагтоа’н	ы н ӄ о р ы о ’ м р ы ӈ а н а г т о а ’ н
гымнинэ игыткин чакэттомгыт ымыльо кымъытвальынтэъым	г ы м н и н э и г ы т к и н ч а к э т _ т о м г ы т ы м ы _ ь о _ к ы м ъ ы т в а _ ь ы н т э _ ъ ы м
галвавыӈӈолен ӄынвэт чейвыткук ынӄэнэ	г а в а в ы ӈ ӈ о е н _ ӄ ы н в э т ч е й в ы т к у к ы н ӄ э н э _
ымы э’чек выква вык ныквынтоӄэн ынӄэнэ	ы м ы э ’ ч е к в ы к в а _ в ы к _ н ы к в ы н т о ӄ э н _ ы н ӄ э н _ э _
э’чек выквыӄагтэ тэгнувъэлеӄин ытльата энанымӈыляквъэ ынӄэн	э ’ ч е к в ы к в ы ӄ а г т э _ т э г н у в ъ _ э е ӄ и н _ ы т ь а т а э н а н _ ы м ӈ ы я к в ъ э _ ы н ӄ э н
ӄытлыги выквылгыӄай тэгнувъэлеӄин тэгныкээӄин ынӄэнэ	ӄ ы т ы г и в ы к в ы г ы ӄ а й _ т э г н у в ъ _ э е ӄ и н _ т э г н ы к э э ӄ и н ы н ӄ э н _ э
нивӄинъым ӄэлюӄ мури нылгиныӈинмури ныӈинмуриы’м ынӄэнэ ы’ттъыгрээн тынинтыгъэн выквылгыӄай	н и в ӄ и н ъ ы м ӄ э ю ӄ _ м у р и н ы г _ и н ы ӈ _ и н _ м у р и н ы ӈ и н м у р и ы ’ м _ ы н ӄ э н э ы ’ т т ъ ы г р э э н _ т ы н и н _ т ы г ъ э н в ы к в ы г _ ы ӄ а й
уйӈэ эчимгъукыльымури ӄэлюӄ нэмыӄэйъым читъым ынӄэнэ тынэёлӄыльымэ ӈутку рэтлетъёлӄыл и’нничгэ и’нничгу гэтэйкытэ ынӄэн выквылгыӄай	у й ӈ э э ч и м г ъ у к ы ь _ ы м у р и _ ӄ э ю ӄ н э м ы ӄ э й ъ ы м _ ч и т ъ ы м _ ы н ӄ э н э _ т ы н э ё _ ӄ ы ь _ ы м э ӈ у т к у р э т е т ъ ё _ ӄ ы _ и ’ н н и ч г э и ’ н _ н и ч г у г э т _ э й к ы т э ы н ӄ э н _ в ы к в ы г ы ӄ а й
ынӄэнъым ынкъам гым итыкэ	ы н ӄ э н ъ ы м ы н к ъ а м г ы м _ и т ы к э _
чакэттомгыӄай уйӈэ гагаляленъым	ч а к э т т о м г ы ӄ а й у й ӈ э _ г а г а я е н _ ъ ы м _
гым ытльата гэнапытӄынлыватлен	г ы м ы т ь а т а _ г э н _ а п ы т ӄ ы н ы в _ а т е н
ынӄэнэ энмэч тъэргииӈит ӈэръамытлыӈгээӈэльэвымэ панэнаъым ынӄэн нылёойгым ытльак ынӄэн	ы н ӄ э н э э н м э ч т ъ э р _ г и и ӈ _ и т _ ӈ э р ъ а м ы т ы ӈ г э _ э ӈ э ь э в ы м э п а н э н а ъ ы м ы н ӄ э н н ы ё _ о й г ы м ы т _ ь а к _ ы н ӄ э н
ялгытык ялгыт ныялгынморэ нытарагӄэнатъым йъэлыги гым ынӄэнэ ытльак тароӈыльын айколятльын нинививым	я г ы т ы к я г ы т _ н ы я г ы н _ м о р э н ы т _ а р а г ӄ э н а т _ ъ ы м й ъ э ы г и г ы м _ ы н ӄ э н э ы т _ ь а к _ т а р о ӈ ы _ ь ы н а й _ к о я т ь _ ы н н и н и в и в ы м
мэмэй аны мыммэмэа’к	м э м э й а н ы м ы м _ м э м э _ а ’ к _
ӈэвэӄы’м нинивӄин	ӈ э в э ӄ ы ’ м н и н и в ӄ и н _
аны евъев евъев	а н ы е в ъ е в е в ъ е в
гымъым ӄэлюӄ ынпыӈэвӄэйэ эпэӄэйъымэ ынӄэнэ ынпычьын чакыгэт гымыкытльэн энмэч ынанэ нэмыӄэй гэнмэйӈэвлинэтэ	г ы м ъ ы м ӄ э ю ӄ _ ы н п ы ӈ э в ӄ э й э _ э п э ӄ э й ъ ы м _ э ы н ӄ э н _ э ы н п ы ч ь ы н ч а к ы г э т _ г ы м ы к ы т ь _ э н _ э н м э ч _ ы н а н э н э м ы ӄ э й _ г э н м _ э й ӈ э в и н _ э т э _
ӈирэчеӈэ ӄынутъымэ ганрагтатлен ынӄэн ӄлявыля тъэче эмӈинӄэгл эмнэнэнэльэъым ынӄэн ӄлявылтэ	ӈ и р э ч е ӈ э ӄ ы н у т ъ ы м _ э г а н р а г т _ а т е н ы н ӄ э н _ ӄ я в ы я _ т ъ э ч е _ э м ӈ и н ӄ э г э м _ н э н _ э н э ь э _ ъ ы м ы н ӄ э н ӄ я в ы т _ э _
ӄунэчеӈэ ы’ттъыёлкэнъым итыкэ ӄайвыквын ытри ӄайвыквыӈа	ӄ у н э ч е ӈ э ы ’ т т ъ ы ё _ к э н ъ ы м _ и т ы к э ӄ а й в ы к _ в ы н ы т р и _ ӄ а й в ы к в ы ӈ _ а _
ӈинӄэгти ынан рымэйӈэвнинэт	ӈ и н ӄ э г т и ы н а н р ы м э й ӈ э в н и н э т _
ӄоры нэмэӈэ уйӈэ нъэлык тумгытумъым нэмэ ынӄэнэ	ӄ о р ы н э м э ӈ э _ у й ӈ э н ъ _ э ы к _ т у м г ы т у м _ ъ ы м н э м э ы н ӄ э н _ э
нэмэ ганрагтатлен нэмэӈэ ӈиръэ ӈинӄэгти выквытыӈатъым льэтыӄай	н э м э г а н р а г т а т е н _ н э м _ э ӈ э ӈ и р ъ э ӈ и н ӄ э г т и _ в ы к в ы т ы ӈ а т _ ъ ы м _ ь _ э т ы ӄ а й
янор омваамгыпы такчитэ лымэвыр афтобуча камаза трэлӄытгъэ элгыӄанъявэты	я н о р о м в а а м г ы п ы _ т а к _ ч и т э ы м э в ы р _ а ф _ т о б _ у ч а к а м а з а т р _ э ӄ ы т г ъ э _ э г ы ӄ а н ъ я в э т ы _
илгыӄэнъевык ынкы н киткит тратвагъа тъэр ы’лёӈэт тратвагъа ӄэлюӄы’м гэмо гымнан титэ трэпириӈынэт въэӈэты	и г ы ӄ э н ъ е в ы к _ ы н к ы н к и т к и т т р а т в а г ъ а _ т ъ э р _ ы ’ _ ё _ ӈ э т _ т р а т в а г ъ а _ ӄ э ю ӄ ы ’ м _ г э м о _ г ы м н а н т и т э т р _ э п и р _ и ӈ ы н э т _ в ъ э ӈ э т ы _
ынӄоры въаӈгыпы въаӈгыпы ынкы трабилетынӈаа’ мачквагты	ы н ӄ о р ы в ъ а ӈ г ы п ы в ъ _ а ӈ г ы п ы _ ы н к ы т р _ а б и _ е т _ ы н ӈ а а ’ м а ч к в а г т ы
мочквайпы трэриӈээ’ чанктпитирбургэты	м о ч к в а й п ы _ т р э р и ӈ э э ’ ч а н _ к т п _ и т и р б у р г э т ы
ынкы трэльуӈынэт гымнинэт чакэттомгыӄай лярича ынкъам гымнин ӈавытлывэӄай vиталина	ы н к ы т р э ь _ у _ ӈ ы н э т г ы м н и н э т ч а к э т т о м г ы ӄ а й _ я р _ и ч а ы н к ъ а м _ г ы м н и н ӈ а в ы т ы в _ э ӄ а й _ и т _ а и н а _
мэсӄээӄын ынкы мытратваа’ дианана транкалровӈынат лыгэн питиргоф тэӈимыръэнут мытрэгитэӈын	м э с ӄ э э ӄ ы н ы н к ы м ы т р а т в а а ’ д _ и _ а н _ а н а _ т р а н к а р о в _ ӈ ы н а т ы г э н п и т _ и р г о _ ф т э ӈ и м ы р ъ э н у т м ы т р э г и т э ӈ ы н _
лыгэнъым ынӄэн майӈынымэӈын чанктпитирбурк транкалровӈын	ы г э н ъ ы м ы н ӄ э н _ м а й ӈ ы н ы м э ӈ ы н _ ч а н _ к т п _ и т и р б у р к т р а н к а р о в _ ӈ ы н
ынкы ткэлиткугъэк тъэргииӈит	ы н к ы т к э и т к у _ г ъ э к _ т ъ э р г и и ӈ и т _
ынӄоры vиталинанэн отпучк ратвагъа мури кынмал мытрэлӄытгъэ аӈӄагты мытрайъоӈын	ы н ӄ о р ы и т а и н _ а н э н _ о т п у ч к _ р а т в а г ъ а м у р и к ы н м а _ м ы т р э ӄ _ ы т _ г ъ э а ӈ ӄ а г т ы _ м ы т р а й ъ о ӈ ы н
ляричанэн ы’лгытумгыӄэй žэня мытрай мытрайъоӈын ынкы мытранымытвагъа тъэр нидэлят	я р и ч а н э н ы ’ _ г ы т у м г ы ӄ э й _ э н я м ы т р а й _ м ы т р а й ъ о ӈ ы н ы н к ы _ м ы т р а н ы м ы т в а г ъ а _ т ъ э р _ н _ и д э _ я т _
ынӄоры нэмэ питирэты мытрэлӄытгъэ	ы н ӄ о р ы н э м э п и т _ и р _ э т ы _ м ы т р э ӄ ы т г ъ э
мэсӄээӄын ынкы мытратвагъа	м э с ӄ э э ӄ ы н ы н к ы м ы т р а т в а г ъ а
нэмэ мачквагты мачквайпы въаӈэты въаӈгыпы элгыӄанъявэты ынкъам ӈутрилы нэмэ мытрарагтыа’	н э м э м а ч к в а г т ы _ м а ч к _ в а й п ы в ъ _ а ӈ э т ы в ъ а ӈ г ы п ы _ э г ы ӄ _ а н ъ я в э т ы _ ы н к ъ а м ӈ у т р и ы н э м э _ м ы т р _ а р а г т ы а’ _
ӄэлюӄы’м диананэн энмэч калеткогыргын рэпкиргъэ	ӄ э ю ӄ ы ’ м д _ и а н а н э н _ э н м э ч к а е т к о г ы р г ы н _ р э п к и р г ъ э _
опопы мачынан мачынан нымачпэляткоа’н кэлиткук	о п о п ы м а ч ы н а н м а ч ы н а н н ы м а ч _ п э _ я т _ к о _ а ’ н к э и т к у к
ытлён нылгинытэӈкэлиткуӄин аммытлыӈ аммытлыӈбалтэ ӄонпы нинэпириӄинэт	ы т ё н н ы г _ и н ы т э ӈ к э _ и т к у ӄ и н а м м ы т ы ӈ а м _ м ы т ы ӈ б _ а т э ӄ о н п ы н и н э п и р и ӄ и н э т
ынӄэ мачынан нымэч нымачпэлятъан	ы н ӄ э м а ч ы н а н н ы м э ч _ н ы м а ч п э _ я _ т ъ _ а н
пэтле рэркылегнинэт кэлиткутумгыт	п э т е р э р к ы _ е г н и н э т _ к э и т к у т у м г ы т
ытръэч	ы т р ъ э ч
айвэ гым пытӄайвэ тыетгъэк элгыӄанъяквыпы	а й в э г ы м п ы т ӄ а й _ в э _ т ы е т г ъ э к _ э г ы ӄ а н ъ я _ к в _ ы п ы
ынкы	ы н к ы
нывилыткуйгыт	н ы в и ы т к у й г ы т _
ынкы ы’твиӈын гэетлин	ы н к ы ы ’ т в и ӈ ы н г э е т _ и н _
вэлыткорак имыръэнутэ ныйылӄин	в э ы т к о р _ а к и м ы р ъ э н у т э н ы й ы ӄ и н _
э’льэлетэ	э ’ ь э е т э
ынкъам мытъенмык элгыӄанъяквыпы пэтле	ы н к ъ а м м ы т ъ е н м ы к э г ы ӄ _ а н ъ я _ к в _ ы п ы п э т е
ӄлявыл мургин гатапаспортӈылен	ӄ я в ы м у р г и н _ г а т а п а с п _ о р т _ ӈ ы е н
ынкъам айвэ ымъылёӈэт тытъымӄупӄэтгъэк	ы н к ъ а м а й в э ы м ъ _ ы ё _ ӈ э т _ т ы т ъ ы м ӄ у п ӄ э т г ъ э к _
ымъысоӈэт ымъылёӈэт тыйылӄэтгъэк	ы м ъ ы с о ӈ э т _ ы м ъ ы ё ӈ э т _ т ы й ы ӄ э т г ъ э к
люутэ пъомпъоӈыт тыльунэт лгинымкыӄин	ю у т э п ъ о м _ п ъ о _ ӈ ы т т ы ь у н э т _ г и н ы м к ы ӄ и н
ынкъам тыгэсеӈӈонат	ы н к ъ а м т ы г э с _ е _ ӈ ӈ о н а т
ынӄэн тынтыяатгъан а’нэлёвыргын ынӄо	ы н ӄ э н т ы н т ы я а т г ъ а н _ а ’ _ н э ё в _ ы р г ы н ы н ӄ о
тръилегъэ пъомпъоӈэты	т р ъ и е г ъ э п _ ъ о м п ъ о _ ӈ э т ы
тыгынтэгъэ пъомпъоӈэты	т ы г ы н т э г ъ э _ п ъ о м п ъ о _ ӈ э т ы
ынӄо мрэнэ гым нагтатэвым	ы н ӄ о м р э н э г ы м _ н а г т _ а т э в ы м _
гым трагтыгъак	г ы м т р а г т ы гъак _
ярагты нагтатгыт	я р а г т ы н а г т а т г ы т
ии ынкъам пъомпъоӈытэ тынмигчирэвнэт	и и ы н к ъ а м п ъ о м _ п _ ъ о _ ӈ ы т э т ы н м и г ч и р э в н э т _
тынититынэт игыт	т ы н и т и т ы н э т и г ы т _
тынчикунэт	т ы н ч и к у н э т
тынчикунэт	т ы н ч и к у н э т
тынчикунэт	т ы н ч и к у н э т
и тынититынэт ынкъам игыт вай ӈан ӈоонӄэн	и т ы н и т и т ы н э т _ ы н к ъ а м _ и г ы т в а й ӈ а н _ ӈ о о н ӄ э н _
гым чит омваамвырочгэты тъанэлёсӄэвык яраг рымагтэты	г ы м ч и т о м в а а м _ в _ ы р _ о ч г э т ы т ъ а н э ё с ӄ э в ы к _ я р а г р ы м а г т э т ы
ынӄо люут ынкы тыльунэт пъомпъоӈыт нымкыӄин	ы н ӄ о ю у т ы н к ы _ т _ ы ь _ у н э т _ п ъ о м п ъ о _ ӈ ы т н ы м к ы ӄ и н
ынкъам тыгэчеӈӈонат	ы н к ъ а м т ы г э ч е ӈ _ ӈ о н а т _
пууръу тытаӈынтыяатын а’нэлёгыргын	п у у р ъ у т ы т а ӈ ы н т ы я а т ы н _ а ’ _ н э ё г ы р г ы н _
ынкъам пъомпъоӈыт тыгисинэт	ы н к ъ а м п ъ о м п _ ъ о _ ӈ ы т т ы г и с и н э т _
наӄам ныгтымранатӄэн	н а ӄ а м н ы г т ы м р а н _ а т ӄ э н _
мрэнэ нэнугым	м р э н э н э н у _ г ы м
и ынкы трагтыгъак	и ы н к ы т р а г т ы _ г ъ а к _
ытръэч	ы т р ъ э ч
гым ынкъам палина гапъомпъоӈӈытаморэ	г ы м ы н к ъ а м п а и н _ а _ г а п _ ъ о м п ъ о _ ӈ ӈ ы т а м о р э
наӄам нилетӄин чама	н а ӄ а м н и е т ӄ и н _ ч а м а _
вэнлыги мытэквэнмыкъым	в э н ы г и м ы т э к в энмык _ ъ ы м
чама ныкитэ ныкытийгатӄэн ныч нымассьачаӈкытийгатӄэн ынкъам тэӈуйӈэ эмрэнкэ	ч а м а н ы к и т э н ы к ы т и й _ г а т ӄ э н _ н ы ч _ н ы м а с с ь _ а ч _ а ӈ к ы т и й г а т ӄ э н ы н к ъ а м т э ӈ у й ӈ э э м р э н к э _
ынкы мытгисинэтэ пъомпъоӈытъым ынкъам лемӄут	ы н к ы м ы т г и с _ и н _ э т э п ъ о м п ъ о _ ӈ ы т ъ ы м ы н к ъ а м е м ӄ у т
лемӄут	е м ӄ у т
ынӄо ынӄо мури мытрагтымык	ы н ӄ о ы н ӄ о м у р и м ы т р _ а г т _ ы м ы к _
нымӈылтэлӄэн ваӈӄарэмакэн куувэӈэ аӈӄальын	н ы м ӈ ы т э ӄ э н в а ӈ ӄ а р _ э м а к э н _ к у у в э ӈ э а ӈ ӄ _ а ь ы н
нивӄинэ ӄол мытинмык нутэк гэткивмури магляльыморэ лгэсьасаӈвыясеэгатӄэн	н и в ӄ и н э ӄ о м ы т и н м ы к _ н у т э к г э т к и в _ м у р и _ м _ а г _ я ь _ ы м о р э г э с ь а _ с а ӈ в ы я с е э г а т ӄ э н
ымыльо ӄол эргыръокы тылӄутгъэкъымэ рэмкын эвын норгымэглетӄэн	ы м ы ь о ӄ о э р г ы р ъ о _ к ы т ы ӄ _ у т _ г ъ э к ъ ы м _ э р э м к ы н э в ы н н о р г ы м _ э г _ е т _ ӄ э н
чинитъыттъыгаканъёк рэмкыт ӄача энмэ нымигчирэтӄинэт	ч и н и т ъ ы т т ъ ы г а к а н ъ ё _ к р э м к ы т ӄ а ч а э н м э _ н ы м и г ч и р э т ӄ и н э т _
нивигым мычейвыткугъэк китаӄуна момавгъак	н и в и г ы м м ы ч е й в ы т к у г ъ э к к и т а ӄ у н а _ м _ о м а в _ г ъ а к
тыльугъэн ӄол каӈэтвальын орвыкъым	т ы ь у г ъ э н _ ӄ о к а ӈ э т в а ь ы н _ о р в ы к _ ъ ы м
ниви тыӈойӈыкыплыгъан	н и в и т ы ӈ о й ӈ ы к _ ы п ы г ъ а н _
нивигым этаны гымнин ынӄэнэ пэнин ӄуӈычгытэйкэвытумгын	н и в и г ы м э т а н ы г ы м н и н ы н ӄ э н _ э _ п э н и н _ ӄ _ у ӈ ы ч г ы т _ э й к э в _ ы т у м г ы н
читъым нэрмэйгым гым нэрмэчитивым ваӈӄарэмак тэйкэвык	ч и т ъ ы м н э р м э й _ гым г ы м _ н э р м э ч и т и в _ ы м _ в а ӈ ӄ а р э м а к _ т э й к э в ы к
тыгитэгъэн ӄытлыги ӄырым ӄытлыги эмнуӈыльын пэгытту	т ы г и т э г ъ э н ӄ ы т ы г и ӄ ы р ы м _ ӄ ы т _ ы г и э м н у ӈ _ ы _ ь ы н п _ э г ы т т у _
чит тыгынтэвыркынъым инэпирии’	ч и т т ы г ы н т э в ы р к ы н _ ъ ы м _ и н э п и р и и ’
мыттэйкэвмыкъым	м ы т т э й к э в м ы к ъ ы м _
лымынкыри энанватъевгъэ ымы инэтрилгъи	ы м ы н к ы р и э н а н в а т _ ъ е в г ъ э _ ы м ы и н э т р и г ъ и _
тагрытыляма муриӈэ	т а г р ы т ы я _ м а м у р и ӈ э
ынӄэнэ гым ипэ кымъыӈэнэ нэнатарычваӈӄэн ӄэлюӄ ӈээккэӄэйивым еп	ы н ӄ э н э г ы м и п э _ к ы м ъ ы ӈ э н э н э н а т _ а р _ ы ч _ в а ӈ _ ӄ э н ӄ э ю ӄ ӈ э э к к э ӄ э й и в _ ы м е п _
нэнатарычваӈӄээтъымэ	н э н а т а р ы ч в а ӈ ӄ _ э э т ъ ы м э
нинэйылӄин гым каарачыко вальэвым ва ынӄэн нэналпынрыӄэн кэгынмычыку	н и н э й ы ӄ и н г ы м к а а р _ а ч ы к о в а _ ь _ э в ы м _ в а ы н ӄ э н н э н а п ы н р _ ы ӄ э н _ к э г ы н _ м ы ч ы к у
ытръэч ынӄэнэ ӄол тынтынэт тыгитэнэт ынин кэгынмытъым	ы т р ъ э ч ы н ӄ э н э ӄ о _ т ы н т ы н э т _ т ы г и т _ э н э т _ ы н и н _ к э г ы н м ы т ъ ы м _
элёльыӈӈоа’тэ аръаля гагты	э ё ь ы ӈ ӈ о _ а ’ т э а р ъ а я г а г т ы
ынӄэн эӄылпэӈэ тыпиринэт ынӈин	ы н ӄ э н э ӄ ы п э ӈ э _ т ы п и р _ и н э т ы н ӈ и н
тынинтысӄивнэт ӈоонрэ каарачыкойпы	т ы н и н т ы с ӄ и в н э т _ ӈ о о н р э к а а р ачыкойпы
ӈоонӄо ы’лык иргъэт	ӈ о о н ӄ о ы ’ ы к и р г ъ э т _
ынӄорыӈэ гамӈылтэтлен апаӄайына	ы н ӄ о р ы ӈ э г а м ӈ ы т _ э т е н _ а п а ӄ а й ы н а
ытчаяӄэйъым гымнинэ эпэӄэйыну нинъэйӈэвивым	ы т ч а я ӄ э й ъ ы м г ы м н и н _ э э п э ӄ э й ы н у _ н и н ъ э й ӈ э в и в _ ы м
ытльэ гымыкытльэн ынӄэнэ ынпыччакит ынпычьын чакыгэт	ы т ь э г ы м ы к ы т ь _ э н ы н ӄ э н _ э ы н п ы ч _ ч а к и т _ ы н п ы ч ь ы н ч а к ы г э т
гымнан эпэӄэйыну нинъэйӈэвивым ынӄэн ынӈинэ	г ы м н а н э п э ӄ э й ы н у н и н ъ э й ӈ э в _ и в _ ы м ы н ӄ э н _ ы н ӈ и н э
ыныкэккэлӄылин ӈэв ӈэвъэнйыръын ӈэ ӈэвъэнъым ынӄэн кымъыӈэ	ы н ы к э к к э ӄ ы _ и н ӈ э в ӈ э в ъ э н й ы р ъ ы н ӈ э ӈ э в ъ э н _ ъ ы м _ ы н ӄ э н _ к ы м ъ ы ӈ э _
ынанъымэ ив гэрэӄылин ӈээккэӄэй арычвокыльин	ы н а н ъ ы м э и в _ г э р э ӄ ы _ и н _ ӈ э э к к э ӄ э й а р ы ч в о _ к ы _ ь и н
ивнин	и в н и н
мачынан ынӄэн э’нӄэыркынъым ынӈэ ынӈэ рычвойвот энтивкэ	м а ч ы н а н ы н ӄ э н э ’ н ӄ э _ ы р к ы н _ ъ ы м _ ы н ӈ э ы н ӈ э р ы ч в _ о й в _ о т _ э н т и в к э _
ытръэч	ы т р ъ э ч
ынӄэн ынӈин тпаак рычвок	ы н ӄ э н ы н ӈ и н т п _ а а к _ р _ ы ч в о к
лгинъыръыӄинэт чавчыват	г и н ъ ы р ъ ы ӄ и н э т ч а в ч ы в а т _
энмэн ръоравэнвыеквэ нылеӄинэт	э н м э н р ъ о р а в э н _ в ы е к в э _ н ы е ӄ и н э т
мэвын ынӈин мэйӈыльын нъывинвэтгъэн	м э в ы н ы н ӈ и н м э й ӈ ы _ ь ы н _ н ъ _ ы в и н в э т г ъ э н
гатваленат ӈэвъэнйыръын ынкъам ӄлявыл	г а т в а е н а т ӈ э в ъ э н й ы р ъ ы н _ ы н к ъ а м ӄ я _ в ы _
ӈэвъэнйыръын ынкъам ӄлявыл гатваленат	ӈ э в ъ э н й ы р ъ ы н ы н к ъ а м ӄ я _ в ы _ г а т в а _ е н а т
ӈэлвыл ыргин уйӈэ гэнъэтлин	ӈ э в ы ы р г и н у й ӈ э _ г э н ъ э т _ и н _
ынан ӄлявыля ӈэвъэнйыръын ивнин	ы н а н ӄ я в ы я _ ӈ э в ъ э н й ы р ъ ы н _ и в н и н
нэльунэт гэкэӈыльыт	н э ь у н э т _ г э к э ӈ ы ь ы т _
ӄлявыля ивнин	ӄ я в ы я и в н и н _
ӄыӄымъяркыплыткы ӄыӄымъяркыплятгэ	ӄ ы ӄ ы м ъ я р к ы п _ ы т к ы ӄ ы ӄ ы м ъ я р к ы п _ я т г э
ӈэвъэн ӈэвъэнэ чайкокат энаръэнан энаръэнэнат ӄымъяркыплятгъэ	ӈ э в ъ э н ӈ э в ъ э н э ч а й к о к _ а т _ э н а р _ ъ э н а н э н а р _ ъ э н э н а т ӄ ы м _ ъ я р к ы п я _ т г ъ э
эӄылпэ рылгъат	э ӄ ы п э р ы г ъ а т _
эӄылпэ чайкок нэнититгъэн увиэ’т эӄылпэ эна эни энаръэнат ӄымъяркыплятгъат	э ӄ ы п э ч а й к о к _ н э н и т _ и т г ъ э н у в _ и э ’ т э ӄ _ ы п э э н а э н _ и э н а р _ ъ э н _ а т ӄ ы м _ ъ я р к ы п я т _ г ъ а т
етгъэт гэкэӈыльыт рылгъат	е т г ъ э т г э к э ӈ ы ь _ ы т _ р ы г ъ а т
нивӄинэт	н и в ӄ и н э т
тэӈуйӈэ мури ныӈо’морэ	т э ӈ у й ӈ э м у р и н ы ӈ о _ ’ м _ о р э _
ныӈо’морэ	н ы ӈ о ’ м о р э _
гарачайонленат рэмкыльыт	г а р а ч а й о н _ е н а т р э м к ы ь ы т _
ӄлявыля ивнин ӈэвъэн	ӄ я в ы я и в н и н _ ӈ э в ъ э н
ӄувиги	ӄ у в и г и
ӈытогъэ ӈэвъэнйыръын ынкы иквъи	ӈ ы т о г ъ э ӈ э в ъ э н й ы р ъ ы н ы н к ы и к в ъ и _
чайкокаӄагэгыт ӄититги	ч а й кок а ӄ а г _ э г ы т ӄ и т и т г и
тъэче ӈирэче ивнин ӈыроча ивнин	т ъ э ч е ӈ и р э ч е и в н и н ӈ ы р о ч а _ и в н и н _
чайкокаӄагэгыт ӄититги	ч а й кок а ӄ а г _ э г ы т ӄ и т и т г и
люут рэннин кукэӈы лгинытгылӄин	ю ут р э н н и н к у к э ӈ ы _ г и н ы т _ г ы ӄ и н _
иквъэтэ	и к в ъ э т э
миӈкыри тури ынӈин чайпаттык	м и ӈ к ы р и т у р и ы н ӈ и н ч а й _ п а т _ т ы к _
нивӄин	н и в ӄ и н
ынӄэн мургин кукэӄэй чинит нычайпатӄэн	ы н ӄ э н м у р г и н к у к э ӄ э й _ ч и н и т _ н ы ч _ а й п а т ӄ э н _
рэмкэ налгээнъатэвгъан кукэӈы	р э м к э н а г э э н _ ъ а т _ э в г ъ а н к у к э ӈ ы
ӄлявыл нивӄин	ӄ я в ы н и в ӄ и н _
нэмыӄэй мургин яаёлӄыл	н э м ы ӄ э й м у р г и н я а ё ӄ ы _
мургин яаёлӄыл	м у р г и н я а ё ӄ ы
рэмкэ ивнин	р э м к э и в н и н
ым ымыльэты ӈэлвыл трэ мытрэйылгыт	ы м ы м ы ь э т ы ӈ э в _ ы _ т р э _ м ы т р э й _ ы г ы т
нэйылгъэн кукэӈы эквэтгъэт рэмкыльыт	н э й ы г ъ э н к у к э ӈ ы э к в э т г ъ э т _ р э м к ы _ ь _ ы т _
тумгэ ивнин ӈэвъэнйы ӈэвъэн	т у м г э и в н и н ӈ э в ъ э н й ы _ ӈ э в ъ э н _
эӄылпэ мынръэйвэнмык	э ӄ ы п э м ы н р ъ _ э й в э н _ м ы к
эӄылпэ гэли гэръэйвэтлинэт ялгытгъат тэӈэӄылпэ	э ӄ ы п э г э и _ г э р ъ э й _ в э т и н э т _ я г ы т г ъ а т т э ӈ э ӄ _ ы п э
янот ръэтъеквэ мытлемыкъым	я н о т р ъ э т ъ е к в э м ы т е _ м ы к _ ъ ы м _
ынӄо гытгыпэлгыкагыргын мытъиргъэнъым	ы н ӄ о г ы т г ы п э г _ ы к _ а г ы р г ы н м ы т ъ и р г ъ э н ъ ы м _
ынӄо мыт омкычыкойпы мытлемыкъым ынӄо мытйынрысӄанмыкъым	ы н ӄ о м ы т о м к ы ч ы к о й п ы м ы т _ е _ м ы к _ ъ ы м _ ы н ӄ о м ы т й ы н р ы с ӄ _ а н м ы к _ ъ ы м
ӈагтагнэты мытлемык йынрысӄыткыната	ӈ а г т а г н э т ы м ы т _ е м ы к й ы н р _ ы с ӄ ы т к ы н а т а
ынӄо мытӈэйыттэнмык янот йиӈ ӈайгыточгыткок мытчайомык ӈайгытолыӈкы	ы н ӄ о м ы т ӈ э й ы т т _ э н м ы к _ я н о т й и ӈ ӈ а й г ы т _ о ч г ы т _ к о к м ы т _ ч а й о м ы к ӈ а й г ы т _ о ы ӈ к ы
ынӄо нэмэ мытӈэйыттэнмык	ы н ӄ о н э м э м ы т ӈ э й _ ы т т _ э н м ы к _
таӈлымынӄо ӈай ӈай ӈайгыпы мытле ӈайыткыната мытлейвымык	т а ӈ ы м ы н ӄ о ӈ а й ӈ а й _ ӈ а й г ы п ы м ы т _ е _ ӈ а й _ ы т к ы н а т а _ м ы т е й в _ ы м ы к
ынӄо мытивыт мыткэӈкэленмык мытчайпанмыкы	ы н ӄ о м ы т и в ы т м ы т к _ э ӈ к э _ е н м ы к _ м ы т ч а й п а н м ы к ы _
мытчайомыкъым и нэмэ мытпъугыркимык	м ы т ч а й о м ы к ъ ы м _ и н э м э м ы т п _ ъ у _ г ы р _ к и м ы к
ынӄэн мыт	ы н ӄ э н м ы т
и ралӄаӈынвы мытчайомык нэмэ	и р а ӄ а ӈ ы н в ы _ м ы т _ ч а й о м ы к н э м э _
ынӄо нэмэ мыт гытгыпэлгыкагыргыт мытъиргъэн	ы н ӄ о н э м э м ы т г ы т _ г ы п _ э г _ ы к _ а г ы р г ы т м ы т ъ и р г ъ э н
и гыр мытръэтпэнрымык и ынкы ковлёрвыӄай	и г ы р м ы т р ъ э т _ п э н р _ ы м ы к _ и ы н к ы к о в ё р _ в ы ӄ а й _
и матачикля мытрагтымык	и м а т а ч и к _ я _ м ы т р а г т ы м ы к
нэрэнмык ӈаанӄоры рамайэты и мытрэсӄивмык	н э р э н м ы к ӈ а а н ӄ о р ы _ р а м а й _ э т ы и _ м ы т р э с ӄ и в м ы к _
ынӄо мытилгытэвмык и мытчаёмгомык и мыткалеткомгомык	ы н ӄ о м ы т и г ы т э в _ м ы к _ и м ы т ч а ё м _ г _ о м ы к и м ы т к а е т _ к о м _ г о м ы к
ытръэч	ы т р ъ э ч
ынйивӈэвэ мынпъоӈӈытамык	ы н й и в ӈ э в э м ы н п ъ о ӈ ӈ ы т _ а м ы к _
ии	и и
янотъым гым трачайогъа ынӄо мынпъоӈӈытама ӄэйвэ’м	я н о т ъ ы м г ы м т р _ а ч а й _ о г ъ а _ ы н ӄ о м ы н п ъ о ӈ ӈ ы т _ а м а _ ӄ э й в э ’ м
янотъым гымэ ӈинӄэгти калеткорагты трэнэквэтэвӈынэтъымэ	я н о т ъ ы м г ы м э _ ӈ и н ӄ э г т и к а _ е т к о р _ а г т ы _ т р э н э к в э т э в ӈ ы н э т ъ ы м _ э
тумгытумэ транӄамэтвавӈынъым	т у м г ы т у м э т р а н ӄ а м э т в а в _ ӈ ы н ъ ы м _
ынӄо мынлеркын	ы н ӄ о м ы н е р к ы н _
чакэттэты трачаёсӄэвъым	ч а к э т т э т ы т р а ч а ё _ с ӄ э в _ ъ ы м
ынкъамэ трилгытэквъэъым травэръэпыгъа трачапокгыпгъа	ы н к ъ а м э т р и г ы т _ э к в ъ э ъ ы м _ т р а в э р ъ э п ы г ъ а _ т р а ч а п о к _ г ы п г ъ а
ынӄо гыныкы травэтгавъёлгыткогъа’м ынкъам мынлеркын мынлеркын	ы н ӄ о г ы н ы к ы т р а в э т г а в _ ъ ё _ г ы т к о _ г ъ а ’ м ынкъам м ы н е р к ы н _ м ы н _ е р к ы н
эгэй	э г э й
торкалеткопаальэвым	т о р к а е т к о _ п а а ь э в ы м
тыта тыталяплытконат ръэнутэт	т ы т а т ы т а я _ п ы т к о н а т _ р ъ э н у т э т
ы’ттъымыт таляплыткогъэ	ы ’ т т ъ ы м ы т т а я _ п ы т к о г ъ э _
та тыталяплытконат ы’ттъымыт	т а т ы т а я п _ ы т к о н а т _ ы ’ т т ъ ы м ы т
кэлеӈынэ ынӄэн ынпыӈэвӄэй гымнин кэлеӈынэ нэнамӈылёйгым	к э е ӈ ы н э _ ы н ӄ э н ы н п ы ӈ э в ӄ э й г ы м н и н к _ э е _ ӈ _ ы н э _ н э н а м ӈ ы ё й г ы м
тыта таляплыткоэ’ тыталяплыткоа’	т ы т а т а я _ п ы т к о _ э ’ т ы т а я п ы т к о а ’ _
нивӄин ӄы ӄыталяпатгэ	н и в ӄ и н ӄ ы ӄ ы т _ а я _ п а т г э _
ынӄэнэ тынпыэ’н таляпат	ы н ӄ э н э т ы н п ы _ э ’ н т _ а я п а т
нывинтивым чама ынӄэн лгипыгыпгэтыльэтӄин таляпат	н ы в и н т и в ы м _ ч а м а ы н ӄ э н г и п _ ы г _ ы п _ г э т ы ь э т ӄ и н т а я п а т
о’тчой ныпыгыпгэтыльэтӄин нинивигым	о ’ т ч о й н ы п ыг ы п _ г э т ы _ ь э т ӄ и н н и н и в и г ы м
вынэ эпэӄэй ынӄэнэ таляпат о’тчой лгипыгыпгэттылеэркын	в ы н э э п э ӄ э й ы н ӄ э н э _ т _ а я _ п а т о ’ т ч о й _ г и п ы г _ ы п _ г э т т ы е э р к ы н
ӄынгэргэквынъым	ӄ ы н г э р г э к в ы н _ ъ ы м
о’тчой нывакъотвайгым н нычимгъуйгым	о ’ т ч о й н ы в а к ъ о т в а й г ы м н _ н ы ч и м г ъ у й г ы м _
кытвылӄун миӈкыри мынгэргэвын	к ы т в ы ӄ у н м и ӈ к ы р и м ы н г _ э р г э в ы н _
эмӄэлелвынэ нивигым этъым мыӄэплюгъэн	э м ӄ э е в ы н э _ н и в и г ы м э т ъ ы м м ы ӄ э п _ ю _ г ъ э н _
н уттытъулӄэгти ни ни пэнъёлгычыко нэнаёйгым	н у т т ы т ъ у ӄ _ э г т и _ н и н и _ п э н ъ ё _ г ы ч ы к о н э н а ё _ йгым
ӄынвэт ынпыӈэвӄэй нэнамӈылёйгым	ӄ ы н в э т ы н п ы ӈ э в ӄ э й н э н а м ӈ ы ё _ й г ы м _
эпэӄэй эты мыӄэплюгъэн	э п э ӄ э й э т ы м ы ӄ э п _ ю _ г ъ э н _
ӄольым нытэнӈыткуӄин аны ванэ ӄы’лтыёгэ	ӄ о ь ы м н ы т э н ӈ ы т к у ӄ и н _ а н ы в а н э ӄ _ ы ’ _ т ы ё _ г э _
ынӈэ эӄэплюкэ	ы н ӈ э э ӄ э п ю _ к э _
тэлёпкаӄай тэлёпкаӄай аны ӄыгывъекви	т э ё п к _ а ӄ а й т э ё п к _ а ӄ а й а н ы ӄ ы г ы в ъ е _ к в и _
ивкэ гыто ӄуӈэлги тэлёпкаӄай	и в к э г ы т о ӄ у ӈ _ э г и _ т _ э ё п к _ а ӄ а й
ыммымэӄэй ыммымэӄэй аны тыэ’нӄэркын	ы м м ы м э ӄ э й _ ы м м ы м э ӄ э й _ а н ы т ы э ’ н _ ӄ _ э р к ы н
ивкэ гынан ӄуӈэлги	и в к э г ы н а н ӄ у ӈ _ э г и _
гымо мыйылӄэркын	г ы м о м ы й ы ӄ э р к ы н _
тэлёпкаӄай тэлёпкаӄай аны ӄаймыгэ ӄаймыгэ	т э ё п к _ а ӄ а й т э ё п к _ а ӄ а й а н ы ӄ а й м ы г э ӄ а й м ы г э
тэлёпкаӄай тэлёпкаӄай аны ӄыгывъекви	т э ё п к _ а ӄ а й т э ё п к _ а ӄ а й а н ы ӄ ы г ы в ъ е _ к в и _
ивкэ гыто ӄаймыгэ тэлёпкаӄай	и в к э г ы т о ӄ а й м ы г э т _ э ё _ п _ к _ а ӄ а й
ыммымэӄэй ыммымэӄэй аны тыэ’нӄэркын	ы м м ы м э ӄ э й _ ы м м ы м э ӄ э й _ а н ы т ы э ’ н _ ӄ _ э р к ы н
ивкэ гынан ӄаймыгэ	и в к э г ы н а н ӄ а й м ы г э
гымо мыйылӄэркын	г ы м о м ы й ы ӄ э р к ы н _
ыммымэӄэй тэлёпкаӄай тэлёпкаӄай аны ӄыгывъекви	ы м м ы м э ӄ э й _ т э ё п к _ а ӄ а й т э ё п к _ а ӄ а й а н ы ӄ ы г ы в ъ е _ к в и _
ивкэ гынан ӄывинтэтги тэлёпкаӄай	и в к э г ы н а н ӄ ы в и н _ т э т _ г и _ т э ё п к _ а ӄ а й
тэлёпка ыммымэӄэй ыммымэӄэй аны тыэ’нӄэркын	т э ё п к а _ ы м м ы м э ӄ э й _ ы м м ы м э ӄ э й _ а н ы т ы э ’ н _ ӄ _ э р к ы н
ивкэ гынан ӄывинтэтги	и в к э г ы н а н ӄ ы в и н _ т э т _ г и _
гымо мыйылӄэркын	г ы м о м ы й ы ӄ э р к ы н _
тэлёпкаӄай тэлёпкаӄай аны ӄыгывъекви	т э ё п к _ а ӄ а й т э ё п к _ а ӄ а й а н ы ӄ ы г ы в ъ е _ к в и _
э’ми гымнин вонныӄай	э ’ м и г ы м н и н в о н _ н _ ы ӄ а й _
ивкэ мыӄамэтвагъак	и в к э м ы ӄ а м э т в а г ъ а к
ыммымэӄэй ыммымэӄэйv э’ми гымнин майӈывонны	ы м м ы м э ӄ э й _ ы м м ы м э ӄ э й _ э ’ м и г ы м н и н м а й ӈ ы в о н _ н ы _
ивкэ гымо нэмыӄэй мыӄамэтвагъак	и в к э г ы м о н э м ы ӄ э й м ы ӄ а м э т в а г ъ а к _
гыто гуӈэлигыт	г ы т о г у ӈ э и г ы т _
этлы	э т ы
гаймэгыт	г а й м э г ы т
этлы	э т ы
гывинтэтигыт	г ы в и н т э т и г ы т _
этлы	э т ы
этлы ынӈэ	э т ы ы н ӈ э
ынӈин ӄывакъотваччын	ы н ӈ и н ӄ ы в а к ъ о т в а ч _ ч ы н _
аӄамэтвака	а ӄ а м э т в а к а
гатваленат тэӈылӄотъым э’ӄэлӄот	г а т в а е н а т т э ӈ _ ы ӄ о т ъ ы м _ э ’ ӄ э ӄ о т
гамаравленат гамаравтайкавленат	г а м а р а в е н а т г а м а р а в _ т а й к а в е н _ а т
ӄэлёӄы’м тэӈылӄот гъэӄэлтэтлин	ӄ э ё ӄ ы ’ м _ т э ӈ ы ӄ о т г ъ _ э ӄ э т э т и н _
э’ӄэлӄот гэтэӈылтэтлин	э ’ ӄ э ӄ о т г э т э ӈ _ ы т э т и н _
э’ми мэ миӈкыриы’м ынӄэн тыр тыркыльиӈын гэлӄытлин	э ’ м и м э м и ӈ к ы р и ы _ ’ м _ ы н ӄ э н _ т ы р т ы р к ы _ ь _ и ӈ ы н _ г э ӄ ы т и н
ы’ттъыгыргынэ гэкэӈэ пыкиргъи’м	ы ’ т т ъ ы г ы р г ы н э г э к э ӈ э _ п ы к и р г ъ и ’ м
тынарагтына йъонэн ынӄэ ныпчеӈиӄинэт	т ы н а р а г т ы н а й ъ о н э н _ ы н ӄ э н ы п _ ч е _ ӈ и ӄ и н э т _
ӈээккэӄэгти наӄам ытри ынӄэнэ ныкытгынтыръоӄэнат гыролмакы ырык	ӈ э э к к э ӄ э г т и н а ӄ а м ы т р и ы н ӄ э н _ э _ н ы к ы т г ы н т ы р ъ о ӄ э н а т _ г ы р _ о м а к ы _ ы р ы к _
тынарагтына тыӈэтинэ ынӄэнэ ӄаавъятыльынэ ы’ттъыгыргын йъонэнъымэ агтаннэнат ынӄэн ӄаат о’раӈоонрэ	т ы н а р а г т ы н а т ы ӈ _ э т и н э ынӄэн _ э ӄ а а в ъ я _ т ы ь _ ы н э ы ’ т т ъ ы г ы р г ы н й ъ о н э н ъ ы м _ э а г т _ а н н э н а т ы н ӄ э н ӄ а а т _ о ’ р а ӈ о о н _ р э _
тынарагтынаъым ы’ттъыгыргын нэнамӈылёӄэн миӈкыриы’м тыркыльиӈын еэ гэл гэ гэлӄытлин	т ы н а р а г т ы н а ъ ы м _ ы ’ т т ъ ы г ы р г ы н н э н а м ӈ _ ы ё ӄ э н м и ӈ к ы р и _ ы ’ м т ы р _ к ы ь и ӈ ы н _ е э г э г э _ г э ӄ ы т _ и н _
тыркыльиӈын э’ми	т ы р к ы ь и ӈ ы н _ э ’ м и
ӈээккэӄэгти ынӄэн ынӄэн льунин тыӈэти	ӈ э э к к э ӄ э г т и ы н ӄ э н ы н ӄ э н ь _ у н и н _ т ы ӈ _ э т и _
льунин тыӈэти’м нивӄин ӈаанӄэнъым вай тыркыльиӈын	ь у н и н т ы ӈ э т и _ ’ м н и в ӄ и н _ ӈ а а н ӄ э н ъ ы м в а й _ т ы р _ к ы ь _ и ӈ ы н _
наташанаъым нинивӄин ӄырымэн ынӄэн тыркыльиӈын ынӄэн	н а т а ш а н а _ ъ ы м н и н и в ӄ и н ӄ ы р ы м э н ы н ӄ э н т ы р _ к ы _ ь _ и ӈ ы н _ ы н ӄ э н
чапаев ытри пэтька гамаравленат	ч а п а е в ы т р и _ п э т ь к а _ г а м а р а в _ е н а т
нвакъотваӄаат	н в а к ъ о т в а ӄ а а т
пэтькана нэран нэнаранвэтгавэтыӄэн чапаев	п э т ь к а н а _ н э р а н н э н а р а н в э т г а в _ э т ы ӄ э н _ ч а п а е в
чапаянни чапаевна нинивӄин	ч а п а я н н _ и ч а п а е в н а _ н и н и в ӄ и н
тилмытирил тилмэ э’льэл ванэ нын нынвэтгаваннэн	т и м ы т и р и _ т и м э э ’ ь э _ в а н э н ы н _ н ы н в э т г а в а н н э н _
пэтька гым виин мриӈээ’к	п э т ь к а г ы м _ в и и н м р и ӈ э _ э ’ _ к _
мури омваамвыльыморэ ӄорагынрэтыльыморэ	м у р и о м в а а м в ы _ ь _ ы м о р э ӄ о р а г ы н р э т ы ь _ ы м о р э
ытлыгын гымнинэ ӄорагынрэтыльу гитлин	ы т ы г ы н г ы м н и н э _ ӄ о р а г ы н _ р э т ы ь _ у г и т и н
ынӄо бригадиро гатвален	ы н ӄ о б р и г а д и р о г а т в а _ е н _
гым нэмыӄэй эмнуӈкы гатвайгым	г ы м н э м ы ӄ э й э м н у ӈ к ы г а т в а й г ы м _
ынкы тымигчирэтгъэк	ы н к ы т ы м и г ч и р э т г ъ э к _
ынӄо тыпэнчиаа’к	ы н ӄ о т ы п э н ч и _ а а ’ к _
ынӄо вай рамайэты тытваӈӈогъак	ы н ӄ о в а й р а м а й _ э т ы _ т ы т в а ӈ ӈ о г ъ а к _
ынӄэн нэмэӈ ӄол итгъи г онмальырыкы грэм онмальыргыеквэ таъэ’м	ы н ӄ э н н э м э ӈ ӄ о _ и т г ъ и _ г о н _ м а _ ь _ ы р ы к ы _ г р э м о н м а _ ь ы р г _ ы е к в э т а ъ э ’ м
эмныӈинӄинэтъым ытри летынтаграв	э м н ы ӈ и н ӄ и н э т _ ъ ы м ы т р и е т ы н т а г р _ а в _
пэнинъым ильуткульын нэнильуткуӈэтъэн ми нэнамӈылёӄаат	п э н и н ъ ы м и ь _ у т к у ь ы н _ н э н и ь у т к у _ ӈ э т ъ э н м и н э н а м ӈ ы ё ӄ а а т _
ынӄэнъымэ	ы н ӄ э н ъ ы м э
ивнинэт янотъым вай опэт мыӄэтвэтгъэкъым оп валы янот мынъылигъэн	и в н и н э т я н о т ъ ы м в а й _ о п _ э т м ы ӄ _ э т _ в э т г ъ э к _ ъ ы м о п в а ы я н о т _ м ы н ъ _ ы и г ъ э н _
ӄорыӈэ	ӄ о р ы ӈ э
ынӈин нильуткульэтӄинъым ивнинэт ръэнутъым мыльуэ’н мыныгйивэвын	ы н ӈ и н н и ь _ у т к у _ ь э т ӄ и н ъ ы м и в н и н э т р ъ э н у т ъ ы м м ы _ ь _ у э ’ н _ м ы н ы г й и в э в ы н
плевыт ӈан э’ми валы ӈутку ӄол гатымӈэвлен лгититэепкы нэналвавморэ льукъым	п е в ы т ӈ а н _ э ’ м и в а ы _ ӈ у т к у _ ӄ о _ г а т ы м ӈ э в е н _ г и т _ и т э _ е п к ы _ н э н а в а в м о р э ь _ у к ъ ы м
ынӄэӄ плевыт янот ӄыльугын	ы н ӄ э ӄ п е в _ ы т я н о т _ ӄ ы ь _ у _ г ы н
ынӈин о’тчой нильуткульэтӄинъым	ы н ӈ и н о ’ т ч о й н и _ ь _ у т к у _ ь э т ӄ и н ъ ы м
эвынэ ӄынвэт тъэраткоӈӈоа’т этынвыт ымы очыткока гэнъэллеэтъым	э в ы н э ӄ ы н в э т т ъ э р а т к о _ ӈ ӈ о а ’ т _ э т ы н в ы т _ ы м ы о ч ы т к о к а _ г э н _ ъ _ э е э т _ ъ ы м
люут мэӈӄо расӄэпыӈэ валят аратыткоӈӈоа’т аакгэӈэтыӈ	ю ут м э ӈ ӄ о р а с ӄ _ э п ы ӈ э _ в а _ я т а р а т ы т к о ӈ ӈ о _ а ’ т а а к _ г э ӈ э т ы ӈ _
онмальынаӈэ ээк рымэйӈэвнинъым	о н м а ь ы н а ӈ э _ э э к р ы м э й ӈ э в н и н ъ ы м
нэльунэт эвын валят ымыльо гэнумэкэвйивлеэт гэгичийивлеэт ымы ръысӄыёлгычыко вальыт гагтоленат	н э ь у н э т _ э в ы н в а я т ы м ы _ ь о _ г э н у м э к э в _ й и в е _ э т г э г и ч и й и в _ е э т ы м ы р ъ ы с ӄ ы ё г ы ч ы к о _ в а _ ь ы т г а г т о _ е н а т
а’ляйпыльын лыгэпэтывалы ынӄэ тымӈэвлен	а ’ я й п ы ь ы н _ ы г э п э т ы в а _ ы ы н ӄ э т ы м ӈ э в е н _
ивнинэт эты вай ӈотӄэн	и в н и н э т э т ы в а й ӈ о т ӄ э н _
ынӄэн рыпэт валяпэгляръок гэлӄутысӄычетлинэтъым	ы н ӄ э н р ы п э т в а я _ п _ э г _ я р ъ о к г э ӄ у т ы с ӄ ы ч е т _ и н э т ъ ы м
энмэн гатвален валвийӈын	э н м э н г а т в а е н в а _ в _ и й ӈ ы н
энмэпы ныралечетӄэн	э н м э п ы н ы р а е ч е т ӄ э н _
энмэпы ныралечетӄэн	э н м э п ы н ы р а е ч е т ӄ э н _
ынӄо ныр ныгаляӄэн рэӄокалгын	ы н ӄ о н ы р н ы г а я _ ӄ э н _ р э ӄ _ о к а г ы н
льунин энмэпы ралечетыльын валвийӈын	ь у н и н э н м э п ы р _ а е ч е _ т ы _ ь ы н в а в и й ӈ ы н
ельой гым нэмыӄэй мыралегъак	е ь о й г ы м _ н э м ы ӄ э й м ы р а е _ г ъ а к _
ӄольым нивӄин	ӄ о ь ы м н и в ӄ и н _
аӈӄак пыкэрыӈӈок чамъам рэриӈэгъэ рэпылӄэтгъэ	а ӈ ӄ а к п ы к э р ы ӈ ӈ о к ч а м ъ а м р э р и ӈ э г ъ э _ р э п _ ы ӄ _ э т г ъ э _
а ӄол вэнлыги вэнлыги мыралечетгъак	а ӄ о в э н ы г и _ в э н _ ы г и _ м ы р а е _ ч е т г ъ а к _
ӄырымъым мыгтогыт рэпы рэпылӄатыӈӈогъа	ӄ ы р ы м ъ ы м м ы г т о г ы т р э _ п ы р э п _ ы ӄ _ а т ы ӈ ӈ о г ъ а _
ралечетгъэ валв яа яачы рэ яачы рэӄокалгын ралеъэъым мимлык аӈӄак пыкирык ын ынӄэн нинивӄин	р а е ч е т г ъ э _ в а в я а я а ч ы _ р э я а ч ы _ р э ӄ _ о к _ а г ы н _ р _ а е ъ э ъ ы м _ м и м ы к а ӈ ӄ а к п ы к и р ы к _ ы н ы н ӄ э н _ н и н и в ӄ и н _
ӈэвэӄы’м ӈан тиквыт ынӈэ аралека мимлык пыкирык рэпылӄэтгъэ	ӈ э в э ӄ ы ’ м ӈ а н _ т и к в ы т ы н ӈ э а р _ а е _ к а _ м и м _ ы к п ы к и р ы к р э п _ ы ӄ э т г ъ э _
вэнлыгиы’м ӄол нивӄин вэнлыги нинивӄин	в э н ы г и ы ’ м _ ӄ о н и в ӄ и н в э н ы г и _ н и н и в ӄ и н _
ельой ивкэ’м ӄэнагтогэ тэӈыннин тэгнилгыӄин ӈэлвыл трэйыл	е ь о й и в к э _ ’ м ӄ э н а г т о г э т э ӈ _ ы н н и н _ т э г _ н и г ы ӄ и н ӈ э в _ ы т р э й ы _
ынӈин вальэвым	ы н ӈ и н в а ь э в _ ы м _
вэнлыги нэмэ нинъэйӈэвйивӄин	в э н ы г и н э м э н и н ъ э й ӈ э в _ й и в ӄ и н _
ельой тэӈувъэлеӈэлвыл мыйылгыт	е ь о й т э ӈ _ у в ъ э е ӈ э в _ ы м ы й ы г ы т
ынӈин вальэвым	ы н ӈ и н в а ь э в _ ы м _
тэӈкэлильыӈэлвыл мыйылгыт	т э ӈ к э и ь _ ы ӈ э в ы м ы й ы г ы т
ынӈин вальэвым	ы н ӈ и н в а ь э в _ ы м _
тэӈыплылыӈэлвыл мыйыл	т э ӈ ы п ы ы ӈ э в ы _ м ы й ы
ынӈин вальэвым	ы н ӈ и н в а ь э в _ ы м _
ынӄо ивнин	ы н ӄ о и в н и н
тэӈи’нкэли и’ӈкэчиӈэвъэнйыръын трэйылгыт трэрэнӈын	т э ӈ и ’ н к э _ и и ’ ӈ к э ч и ӈ э в _ ъ э н й ы р ъ ы н т р э й ы г ы т т р э р э н ӈ ы н _
йытонэн	й ы т о н э н
иа’м гынмыеп ивкыльигыт	и а ’ м г ы н м ы е п и в к ы ь _ и г ы т _
йытонэн	й ы т о н э н
ынӈин тъэче кивык ӄонпы ныралечетысӄэвӄэн ӄонпы	ы н ӈ и н т ъ э ч е к и в ы к ӄ о н п ы _ н ы р _ а е _ ч е _ т ы с ӄ _ э в ӄ э н ӄ о н п ы
тъэче кивкинэк вытку рэннин и’ӈкэлиӈэвъэнйыръын	т ъ э ч е к и в к и н э к в ы т к у р э н н и н _ и ’ _ ӈ _ к э _ и ӈ э в _ ъ э н й ы р ъ ы н
рырагтаннэнъым ивнин	р ы р а г т а н н э н ъ ы м и в н и н
аввэткынка нывакъотваӄэн	а в в э т к ы н к а н ы в а к ъ о т в а ӄ э н _
ӈэвъэнйыръын таӈванэ ымы нилюльэтгъэн	ӈ э в ъ э н й ы р ъ ы н т а ӈ в а н э _ ы м ы _ н и ю _ ь _ э т г ъ э н
имыръэнут нинэнэймэвӄин ӄутын ӄольым ӄырым ымыӈ э’нӄу лыӈыркын ынӈин нымкыче	и м ы р ъ э н у т н и н э н э й м э в ӄ и н ӄ у т ы н ӄ о _ ь _ ы м _ ӄ ы р ы м _ ы м ы ӈ э ’ н ӄ у ы ӈ _ ы р к ы н _ ы н ӈ и н _ н ы м к ы ч е _
гым матчьатгъа этъопэл	г ы м м а т ч ь а т г ъ а _ э т ъ о _ п э
тылгыръугъи	т ы г ы р ъ у г ъ и
ынык ӄача атчьатгъэ	ы н ы к ӄ а ч а а т ч ь а т г ъ э
гэлгыръулин	г э г ы р ъ у и н
ытръэч	ы т р ъ э ч
вапаӄат вапаӄат вапаӄат вапаӄат вапаӄат вапаӄат	в а п а ӄ а т в а _ п а ӄ а т в а _ п а ӄ а т в а _ п а ӄ а т в а _ п а ӄ а т в а _ п а ӄ а т
вапаӄат гымнин	в а п а ӄ а т г ы м н и н _
вапаӄат э’ми	в а п а ӄ а т э ’ м и _
вапаӄат уйӈэ	в а п а ӄ а т у й ӈ э _
уйӈэ	у й ӈ э
уйӈэ	у й ӈ э
уйӈэ	у й ӈ э
уйӈэ	у й ӈ э
ванныт рынныт ванныт рынныт ванныт рынныт ванныт рынныт ванныт рынныт ванныт рынныт ванныт рынныт ванныт рынныт	в а н н ы т р ы н н ы т в а н _ н ы т р ы н н ы т _ в а н _ н ы т р ы н н ы т _ в а н _ н ы т р ы н н ы т _ в а н _ н ы т р ы н н ы т _ в а н _ н ы т р ы н н ы т _ в а н _ н ы т р ы н н ы т _ в а н _ н ы т р ы н н ы т _
аны вай ӈавлыӄай мынрагтымык	а н ы в а й ӈ а в ы ӄ а й _ м ы н р а г т ы м ы к _
тыӈэлӄотна нэнатвыӄэн	т ы ӈ э ӄ о т н а _ н э н а т в ы ӄ э н
ӄоле итгъэт ӄынвэтэ ӈиръэ ӈэвысӄэтти элерэты натанат	ӄ о е и т г ъ э т ӄ ы н _ в э т э _ ӈ и р ъ э _ ӈ э в ы с ӄ э т т и э е р _ э т ы _ н а т _ а н а т
ӄол вэтгавӈавъым ӄол камэлгыӈав	ӄ о в э т г а в ӈ а в ъ ы м _ ӄ о _ к а м э г ы ӈ а в _
ынкы илирыкы нантыӈӈонатъым	ы н к ы и и р ы к ы _ н а н _ т ы ӈ ӈ о н а т ъ ы м _
ӄоры ӄолетъылёӈ иквъэтэ о’равэтльат эчвэра игыт мэтчимгъунӈээ’тэ	ӄ о р ы ӄ о е т _ ъ ы ё _ ӈ и к в ъ э т э о ’ р а в э т _ ь а т _ э ч в э р а и г ы т м э т ч и м г ъ _ у н _ ӈ э _ э ’ т э
этъым мыныгытынат мынривлынэт	э т ъ ы м м ы н ы г ы т ы н а т _ м ы н р _ и в ы н э т
ынпыначгын иквъиӈа амвынэ	ы н п ы н а ч г ы н и к в ъ и ӈ а а м _ в _ ы н э
камэлгыӈав ӄри ӄривлыгыткы	к а м э г ы ӈ а в ӄ _ р и ӄ р и в _ ы г ы т к ы
ынкъам вэтгавӈав виин ынкы опопы ӄээӄын нрэчимгъунӈэӈгъэн	ы н к ъ а м в э т г а в ӈ а в в и и н _ ы н к ы _ о п о п ы ӄ э э ӄ ы н _ н _ р э ч _ и м г ъ у н _ ӈ _ э ӈ г ъ э н
гымнан торывтатык нинэгичийгымэ вытвыттэ рымавыттэ ръэнут	г ы м н а н т о р ы в т _ а т ы к _ н и н э г и ч и й г ы м э _ в ы т в ы т т э р ы м а в ы т т э _ р ъ э н у т _
рымавыттэ’м нинэнръэлевивым ынкы гэвтыт лыгэвытвыттэ	р ы м а в ы т т э ’ м _ н и н э н р ъ э е в _ и в ы м ы н к ы г э в т ы т _ ы г _ э в ы т в ы т т э _
нэнапатэвым	н э н а п а т э в ы м
ынӄоры нинэлпиттивым	ы н ӄ о р ы н и н э п и т т _ и в _ ы м
ынӄоры виин уӄӄэмчыку ынӈин нинэнрэӄэвивым	ы н ӄ о р ы в и и н у ӄ ӄ э м ч ы к у ы н ӈ и н _ н и н э н _ р э ӄ _ э в _ и в _ ы м
чеэкэй нымэчвилетӄинъым	ч е э к э й н ы м э ч в и _ е т ӄ и н _ ъ ы м
нэнаталяйгым нинэкилитивым	н э н а т а я й г ы м н и н _ э к и и т и в _ ы м
ынӄоры нэмэ нинэнкувлюкэвивым	ы н ӄ о р ы н э м э н и н э н к у в _ ю _ к э в _ и в ы м
виин нинэнӄитэтивым ӄэтырачыко	в и и н н и н э н ӄ и т э т и в _ ы м _ ӄ э т ы р а ч ы к о
ынӄоры льэлеӈкы нэнагтойгым	ы н ӄ о р ы ь э е ӈ к ы _ н э н а г т _ о й г ы м
рыпонталгав нэнаталяморъэм нинэнумури рымытӄылгавкы	р ы п о н т а г а в _ н э н а т а я м о р ъ э м _ н и н э н у м у р и р ы м ы т ӄ ы г _ а в к ы
тэӄэмэӈ ынӈин вальын	т э ӄ э м э ӈ ы н ӈ и н в а ь ы н _
тан нивӄин эты танӈыӈавиӈын	т а н н и в ӄ и н э т ы т а н ӈ ы ӈ а в _ и ӈ ы н _
колё майӈылёльо	к о ё м а й ӈ ы ё _ ь о
нивӄин	н и в ӄ и н
люут ӈэвысӄэт чинит иквъи	ю ут ӈ э в ы с ӄ э т ч и н и т _ и к в ъ и
о’тчой вытку вулӄытви	о ’ т ч о й в ы т к у в у ӄ _ ы т в _ и _
мури ӈакалгын ынмынкав гым ынкъам ӄольым наташа канунникава	м у р и ӈ а к а г ы н _ ы н _ м ы н к а в г ы м _ ы н к ъ а м ӄ о ь _ ы м _ н _ а т а ш а _ к а н у н н и к а в а _
тэӈ тэӈкэлиткукы танӈынотагты нэнӈивмык	т э ӈ т э ӈ к э и т к у _ к ы _ т а н ӈ ы н о т а г т ы н э н ӈ и в м ы к
ынкъам акватыӈӈок нивӄинэт рэпкирӈытык танӈынотак ынӈэ ив ынӈэ ынӈэ аг агтывэ агтывэтгавыльаткэ	ы н к ъ а м а к в а т ы ӈ ӈ о к н и в ӄ и н э т р э п к и р ӈ ы т ы к _ т а н ӈ ы н _ отак _ ы н ӈ э _ и в _ ы н ӈ э ы н ӈ э _ а г _ _ а г т ы _ в э _ _ а г т ы в э т г а в ы _ ь а т к э
ӄыгитэ нымэйыӈӄинэтэ умкыт	ӄ ы г и т э н ы м э й ы ӈ ӄ и н э т э у м к ы т _
танӈынотак мытыпкирмыкъым	т а н ӈ ы н о т а к м ы т ы п к и р м ы к ъ ы м _
мытльунэт нымэйыӈӄинэт умкытэ	м ы т ь у н э т н ы м э й ы ӈ ӄ и н э т _ у м к ы т э
ӈакалгын гымнан тиквъэн ӄыгитэ нытэӈӄинэт въэгти	ӈ а к а г ы н г ы м н а н _ т и к в ъ э н ӄ ы г и т э _ н ы т э ӈ ӄ и н э т _ в ъ э г т и
мурыгрээн кэлиныгйивэтыльын нивӄин иа’мэ майӈывэтгавыркынэтык ынӄэн нэгитэркынитык	м у р ы г р э э н к э и н _ ы г й и в э т ы _ ь ы н н и в ӄ и н и а ’ м э м а й ӈ _ ы в э т г а в _ ы р к ы н э т ы к ы н ӄ э н _ н э г и т э р к ы н и т ы к
гымнанъым тиквъэн ванэ ӄивтык ынӄэнэ въэ въэгти энмэн тыльунэт	г ы м н а н ъ ы м т и к в ъ э н _ в а н э ӄ и в _ т ы к ы н ӄ э н _ э _ в ъ э в ъ э г т и _ э н м э н т _ ы _ ь _ у н э т _
нымӈылтэлӄэнат эмнуӈыльыт ынӄэн ынпыначгыт ынӄэнэ	н ы м ӈ ы т э ӄ э н а т э м н у ӈ ы _ ь ы т _ ы н ӄ э н ы н п ы н а ч г ы т ы н ӄ э н э _
ӄорагынрэтыльына а’ачек а’ачек ынӄэн гаӄэтывъэӈӈоленэ	ӄ о р а г ы н р э т ы ь _ ы н а а ’ а ч е к а ’ а ч е к ы н ӄ э н г а ӄ _ э т ы в ъ э ӈ ӈ о _ е н _ э _
нутэк ӄорагынрэтыльын ынӄэн	н у т э к ӄ о р а г ы н р э т ы _ ь ы н _ ы н ӄ э н
и’гэ нано наномаваквъан	и ’ г э н а н о н а н о м _ а в а _ к в ъ а н
ынӄэн и’гэ и’гэ ынӄэ наноно наномаваквъан	ы н ӄ э н и ’ г э и ’ г э ы н _ ӄ э _ н а н _ о н о _ н а н о м а в а _ к в ъ а н
и’гчыкуӈ ынкы гомавлен	и ’ г ч ы к у ӈ _ ы н к ы г о м а в е н _
ынӄэн ынӈин егтэ ег нэнъегтэлев	ы н ӄ э н ы н ӈ и н е г т э _ е г _ н э н _ ъ е г _ т э _ е в
ынӄэн нэнъегтэлев	ы н ӄ э н н э н ъ е г _ т э _ е в
чапаевна пэтька ивнин	ч а п а е в н а _ п э т ь к а и в н и н _
ытлён микынэ а’ляёран э’лерылгэ тивыркынин	ы т ё н м и к ы н э _ а ’ я ё _ р а н _ э ’ е р ы г э т и в _ ы р к ы н и н
ӄыныгйивэквынэ микынэ ынӄэна ынӈин рытыркынин	ӄ ы н ы г й и в э к в ы н э _ м и к ы н э ы н ӄ э н а ы н ӈ и н _ р ы т ы р к ы н и н _
пэтле пэтька рэсӄиквъим иквъиӈа	п э т е п э т ь _ к а р э с ӄ и к в ъ и _ м и к в ъ и ӈ а _
вынэ ӈан фурмановына	в ы н э ӈ а н ф у р _ м _ а н о _ в ы н а
иа’м гынан ынӈин ивыркын	и а ’ м г ы н а н ы н ӈ и н и в ы р к ы н _
таӈамынан а’ляёрайпы ӈыток кэгынмыт нинилгытэвӄинэт	т а ӈ а м ы н а н а ’ я ё р _ а й п ы _ ӈ ы т о к к э г ы н м ы т н и н _ и г ы т _ э в ӄ и н э т
мури мытъанэлёсӄэвмык ильъя гым ымы чаша	м у р и м ы т ъ а н э ё _ с ӄ э в _ м ы к и ь ъ я г ы м _ ы м ы ч а ш _ а _
мытынтымӈэвын ильъя ярак ӄача	м ы т ы н т ы м ӈ э в ы н и ь _ ъ я я р а к _ ӄ а ч а
вытку тыльуэ’нэ гэчеэмык ӄача тыльуэ’н	в ы т к у т ы ь _ у _ э ’ н э г э ч е э м ы к ӄ а ч а т _ ы ь _ у _ э ’ н
тыгитээ’н уйӈэ ильъяъым ынкъа тэючгын ги ганалгыма	т ы г и т э э ’ н у й ӈ э _ и ь ъ я _ ъ ы м _ ы н к ъ а т э ю ч г ы н г и _ г а н а г _ ы м а _
ӄытлыги мытнэрэтъэн ярак ӄача	ӄ ы т ы г и м ы т н _ э р э т ъ э н _ я р а к ӄ а ч а
ынӄо чаша гэпэлӄынтэлин гагтылен ильъя	ы н ӄ о ч а ш а _ г э п _ э ӄ ы н т э и н _ г а г т ы е н и ь _ ъ я
ынӄо мытылӄынмык ро рочгэтыы’м	ы н ӄ о м ы т ы ӄ ы н м ы к _ р о _ р о ч г э т ы ы ’ м _
ынӄо ынӄо мытъирмыкэ	ы н ӄ о ы н ӄ о м ы т ъ и р _ м ы к _ э _
ро ро роч рочгэты ынӄэн миӈкы нытваӄэн мургин	р о р о р о ч р о ч г э т ы _ ы н ӄ э н _ м и ӈ к ы _ н ы т в а ӄ э н _ м у р г и н _
мытымпэмыкэ мытчайпанмык	м ы т ы м п э м _ ы к э м ы т ч а й п а н м ы к
чаша ныкупрэгитэӄин	ч а ш а н ы к _ у п р э г и т э ӄ и н _
мури нычайоморэ	м у р и н ы ч а й о м о р э _
ынӄо чайоплыткокэ чашана тэйкынин гымнинэ орвыӄай ынӄэнэ	ы н ӄ о ч а й о п ы т к о к _ э _ ч а ш а н а т э й к ы н и н _ г ы м н и н э о р в _ ы ӄ а й _ ы н ӄ э н э _
нъанэлёморэ ынкъа орвыръараӄӄагтэ	н ъ а н э ё м о р э _ ы н к ъ а о р в ы р ъ _ а р а ӄ ӄ а г т э _
ынкы ныйымэтваӄэнатэ гыръоӈ ӄнут гыръоӈавыръэнутэт	ы н к ы н ы й ы м э т в а _ ӄ э н а т _ э г ы р ъ о ӈ ӄ н у т _ г ы р ъ о ӈ а в _ ы р ъ э н у т э т _
ынӄо ильъя гэннулин	ы н ӄ о и ь ъ я _ г э н _ н у и н
чинит гэнвылин орвыӄай ынӄэнэ	ч и н и т г э н в ы и н _ о р в _ ы ӄ а й ы н ӄ э н э _
ынӄо гэннулин	ы н ӄ о г э н н у и н _
ынӄо нэмэ мытчаёмык	ы н ӄ о н э м э м ы т ч а ё _ м ы к _
ынӄо вытку чаёплыткок ильъя ытри чаша гарагтыленат	ы н ӄ о в ы т к у ч а ё п _ ы т к о к _ и _ ь ъ я ы т р и _ ч а ш а _ г а р _ а г т ы е н а т _
тэленъеп колё ръилечитльэтлеэт таӈымльаляӈэт таӈымыльо нымнымытъым	т э е н ъ е п к о _ ё р ъ и е _ ч и т ь э т _ е э т т а ӈ ы м ь а я ӈ э т _ т а ӈ ы м ы ь о н ы м н ы м _ ы т ъ ы м
ынкъамэ ӄол нитӄинэт нымӈылтэлӄэнатэ таӈамалва вальын э’рагыргын нытваӄэнъымэ	ы н к ъ а м э ӄ о н и т ӄ и н э т _ н ы м ӈ ы т э ӄ э н а т _ э _ т а ӈ а м _ а в а в а ь ы н _ э ’ р а г ы р г ы н _ н ы т в а ӄ э н ъ ы м _ э
ӄол итгъэтэ тэленъеп нивӄээт гагтытантэйкыли гаканйыӈ	ӄ о и т г ъ э т э _ т _ э е н ъ е п н и в _ ӄ э э т г а г т _ ы т а н т э й к ы _ и г а к а н й ы ӈ
яноттыляк минринэтгъиӈэ гаканйыӈа	я н о т т ы я к м _ и н р и н э т г ъ и _ ӈ э г а к а н й ы ӈ а
ынӄэнэ гакоолгыле ынръама ръилельынъым	ы н ӄ э н э г а к о о г _ ы е ы н р ъ а м _ а р ъ и е _ ь ы н ъ ы м _
амгаканйыӈа яноттыляка пыкиргъиӈэ	а м г а к а н й _ ы ӈ а я н о т т ы я к а п ы к и р г ъ и _ ӈ э
таӈранъав орвоор нылеӄин	т а ӈ р а н ъ а в о р в о о р _ н ы е ӄ и н
тэӈлюӈымылельын тэӈэвыт ныви яноттыляк ӄача пыкиргъи нывилгъи	т э ӈ ю ӈ ы м _ ы е ь ы н т э ӈ э в ы т н ы в и _ я н о т т ы я _ к ӄ а ч а _ п ы к и р г ъ и н ы в и г ъ и _
этынвынъым пэ поӄытгагтыёлго ытръэч нылгыӄин чьэчеӈвыйичыку	э т ы н в ы н ъ ы м п э _ п о ӄ ы т г _ а г т ы _ ё г о ы т р ъ э ч н ы г ы ӄ и н ч ь э ч е ӈ _ в _ ы й и ч ы к у _
ӄытлыги гакоолгылен	ӄ ы т ы г и г а к о о г _ ы е н _
элгааткоӈӈок мургин рэмкын гъэраӄорлена	э г а а т к о ӈ ӈ о к _ м у р г и н р э м к ы н г ъ э р _ а ӄ _ о р _ е н а
гъэраӄорлен таӈымыльо гэетръулинэтэ ямганымгынымгыпы ям ян ян ямна гын нымнымгыпы	г ъ э р а ӄ о р _ е н т а ӈ ы м ы ь о г э е т _ р ъ у и н э т э _ я м г а н ы м _ г ы н ы м г ы п ы я м я н я н _ я м _ н а _ г ы н _ н ы м н ы м г ы п ы
лгинымкыӄин о’равэтльан гэетлин	г и н ы м к ы ӄ и н о ’ р _ а в э т ь а н г э е т _ и н
лгэгэчевкы гатваморэ	г э г э ч е в к ы г а т в а м о р э _
лгэн рэмкын нилюльэтӄинэ	г э н р э м к ы н н и _ ю _ ь _ э т ӄ и н э
чама ныръилеӄинэт	ч а м а н ы р ъ и е ӄ и н э т _
ныгэкэӈыльэтӄинэт чама нырачвыӈӄэнат чама нытэйкэвӄинэт	н ы г э к э ӈ ы ь _ э т ӄ и н э т ч а м а н ы р а ч в ы ӈ ӄ э н а т ч а м а н ы т э й к э в ӄ и н э т _
чама таӈнырэлӄыпатӄэнат	ч а м а т а ӈ н ы р э ӄ _ ы п _ а т ӄ э н а т
чама рэн йъа галгэтаранлен рэмкын	ч а м а р э н й ъ а _ г а г _ э т _ а р а н е н _ р э м к ы н
лгэнарагчельатӄэнат нылгитэӈычьэтӄин рэмкын	г э н а р а г ч е ь а т ӄ э н а т _ н ы г и т э ӈ ы ч ь э т ӄ и н р э м к ы н _
муриы’м нылгэлвавморэ милгынъюнэвкы	м у р и ы ’ м н ы г _ э в а в м о р э _ м и г ы н ъ ю н _ э в к ы
мургинэт уттыт гэлгийъэтитӄэтлинэт ӈэргэрык	м у р г и н э т у т т ы т г э г и й _ ъ э т _ и т ӄ _ э т и н э т ӈ э р г э р ы к
плыткукэ рэмкынэ клюбэты гэлгилӄытръулин ынкы	п ы т к у к э р э м к ы н э _ к ю _ б э т ы _ г э г и ӄ ы т р ъ у _ и н ы н к ы
рэмкын клюбык гаканчертлен	р э м к ы н к ю б _ ы к _ г а к а н ч е р т е н _
гым эмнуӈкы тъурэтгъэк	г ы м э м н у ӈ к ы т ъ ур _ э т г ъ э к _
гымнинэт ытльат гымнин ытлыгын ынкъам ытля гымнинэт ытльат ынкъам ытлыгыт чачча ныялгытӄэнатъым	г ы м н и н э т ы т ь а т _ г ы м н и н _ ы т ы г ы н ы н к ъ а м _ ы т _ я г ы м н и н э т _ ы т _ ь а т _ ы н к ъ а м _ ы т ы г ы т ч а ч _ ч а _ н ы я г ы т _ ӄ э н а т ъ ы м _
люут ёъоръогъэ	ю ут ё ъ _ о р ъ о г ъ э
ынӄо тылянвык нытваӄэн алвабригаден яратъым	ы н ӄ о т ы я н в ы к н ы т в а ӄ э н _ а в а _ б р и г а д е н _ я р а т _ ъ ы м
ынкы гым тъурэтгъэк алваярак	ы н к ы г ы м т ъ у р _ э т г ъ э к _ а в а _ я р а к
гэмэлетлин айвэ’м эргатыкъым	г э м э е т и н _ а й в э ’ м э р г а т ы к ъ ы м _
ытлыгэ тэйкынин яраӈы	ы т ы г э т э й к ы н и н я р а ӈ ы _
ынӄо мури ыммэмы мытрагтымык	ы н ӄ о м у р и ы м м э м ы _ м ы т р _ а г т _ ы м ы к
ынӄо мытъялгынмык пятельэпы	ы н ӄ о м ы т ъ я г ы н м ы к _ п _ я т е ь _ э п ы
нилгытэвивым нычайойгым ныӄамэтвайгым нэмэ нывийгым волӄытвэӄамэтвак роолӄыл	н и г ы т э в и в _ ы м н ы ч а й о й г ы м н ы ӄ а м э т в а _ й г ы м н э м э н ы в _ и й г ы м в о _ ӄ ы т в _ э ӄ а м э т в а _ к р о о ӄ ы
ынръам гэрэӄылин мургин ынпыӈэвыӈ тэӈэвыт рыгыткукинэт тут тынуттылеркыт тынутчиргъи	ы н р ъ а м г э р э ӄ ы _ и н _ м у р г и н ы н п ы ӈ э в ы ӈ т э ӈ _ э в ы т _ р ы г ы т к у к _ и н э т т у т _ т ы н у т т ы е р _ к ы т _ т ы н у т ч и р г ъ и
ыннэн тэӈыннэ ӄилгытэквынэт кэгынмыт рычвантоплыткок	ы н н э н т э ӈ ы н н э ӄ _ и г ы т _ э к в ы н э т _ к э г ы н м ы т р ы ч в а н т о _ п ы т к о к _
нинивӄин ӄылпыркын ӄылпигын	н и н и в ӄ и н ӄ ы п ы р к ы н ӄ ы п _ и г ы н _
э’тки вае тынанӄыпаатгъак эвниквичильэткэ опопы мэчынкы	э ’ т к и в а е т ы н а н _ ӄ ы п _ а а т г ъ а к _ э в н и к в и ч и ь _ э т к э о п о п ы м э ч ы н к ы
кинольыт ыныкит ӈан риӈэ’твэ риӈэ’твэъымэ	к и н о ь ы т ы н ы к и т _ ӈ а н р и ӈ э ’ т _ в э _ р и ӈ _ э ’ т в э ъ ы м _ э
ръэнут риӈэ’твыӄэгти ӈан нытваӄэнат аннушкано нылгыӄинэт	р ъ э н у т р и ӈ э ’ т в _ ы ӄ э г т и _ ӈ а н н ы т в а ӄ э н а т а н н у _ ш _ к _ а н о н ы г ы ӄ и н э т
ынӄоръым льэльэнры ӄынвэт льэленръугъи’м	ы н ӄ о р ъ ы м ь э ь _ э н р _ ы ӄ ы н в э т ь э е н _ р ъ у г ъ и _ ’ м
нутгыӄээтэ этъым пэлгома пэлгома чама нывинӄинэт	н у т г ы ӄ э э т э э т ъ ы м _ п э г о м а п э г _ о м а _ ч а м а н ы в и н _ ӄ и н э т
рэӄо каяку каюку нылгыӄинэ эчкимочльама	р э ӄ о к а я _ к у к а _ ю к у н ы г _ ы ӄ и н э э ч _ к и м о ч ь а м а _
муръим ӄолеёрочыко мытмэйӈэнмык гымнин ынинэльын рэнто нутэӈэвыт чакы кэйӈавыт гым якоӄай	м у р ъ и м ӄ о е ё _ р о ч _ ы к о м ы т м э й ӈ э н м ы к г ы м н и н _ ы н и н э ь ы н _ р э н _ т о н у т э ӈ э в ы т ч а к _ ы к э й ӈ _ а в ы т _ г ы м я к о _ ӄ а й
ӄутти нынтоӄэнат ынӄоръым	ӄ у т т и н ы н т о ӄ э н а т ы н ӄ о р ъ ы м
ынъэӄэйынъэмэ гымнинъым ынӄэн ынпычьэкык иниквъи	ы н ъ э ӄ э й ы н _ ъ э м э г ы м н и н ъ ы м ы н ӄ э н ы н п ы ч ь _ э к ы к и н и к в ъ и _
э’мъим ӄыччым э’тки э’тки тъэнӄэыччын ягмалеччо итык	э ’ м ъ и м ӄ ы ч ч ы м _ э ’ т к и э ’ т к и _ т ъ э н ӄ э _ ы ч _ ч ы н _ я г м а е ч _ ч о и т ы к
тымӈэӈырачьэтъым лиӈыткучьын нылеӄинъымэ ӈэвэӄ нынтовэрэнморэ ымыльо	т ы м ӈ э ӈ ы р а ч ь э т _ ъ ы м и ӈ ы т к у ч ь ы н н ы е _ ӄ и н ъ ы м э _ ӈ э в э ӄ н ы н т о в э р _ э н м _ о р э ы м ы ь о
нинэйӈэмури ӈэвэӄэ нытиӈэӈӈымури орвыт	н и н э й ӈ э м у р и ӈ э в э ӄ _ э н ы т и ӈ _ э ӈ ӈ ы м у р и _ о р в ы т
нинэтиӈэӈӈу нинэтиӈэӈӈымури орвыт	н и н э т и ӈ э ӈ ӈ у _ н и н э т и ӈ э ӈ ӈ ы м у р и _ о р в ы т
лыгэн ӈэнрильым у’рэӈэнри нылемури нымгутылемури ымъылёӈэт	ы г э н ӈ э н р и ь _ ы м у ’ р э ӈ э н р и _ н ы е м у р и н ы м _ г у _ т ы е _ м у р и ы м ъ ы ё ӈ э т _
ӈуттэлвъэм валёмгъэ	ӈ у т т э в ъ э м в а _ ё м г ъ э _
имлетгынтэвъыма амноӈэты рэмкына тэӈыръилельэтӄинэ гынтэвтылеӄинэт	и м е т г ы н т э в ъ ы м а _ а м н о ӈ э т ы р э м к ы н а т э ӈ _ ы р ъ _ и е ь _ э т ӄ и н э г ы н т э в т ы е ӄ и н э т _
наӄамэ э’йӈэвыткуркынитык винрэттумгъум	н а ӄ а м э э ’ й ӈ э в ы т к у р к ы н _ и т ы к в и н р э т _ т у м г ъ у м _
кабинак ӄыӈэлӄиквъима ы’ттъыёлвизьдиxодыкъыма	к а б ин а к ӄ ы ӈ _ э ӄ и к в ъ и м а _ ы ’ т т ъ ы ё в и з _ ь д и о д ы к ъ ы м а
ынӄорыӈ эквыйынрэпы люут мыттамкъым	ы н ӄ о р ы ӈ э к в ы й ы н р э п ы ю _ у т _ м ы т т а м _ к ъ ы м _
ытльатаӈ эмнуӈкы гэ гэнагтолен о	ы т ь а т а ӈ _ э м н у ӈ к ы г э г э н а г т о _ е н _ о _
ынӄорыӈ ытлыгынэ гатъылыӈӈолен ынӄэн	ы н ӄ о р ы ӈ ы т ы г ы н э _ г а т _ ъ ы ы ӈ ӈ о _ е н ы н ӄ э н
э’чуулгычыку люут ръэнут пэглягъэ	э ’ ч у у г ы ч ы к у _ ю у т р ъ э н у т п э г _ я г ъ э _
айвэ гым чит нъалегы нъанэлёсӄэвым	а й в э г ы м ч и т н ъ _ а е _ г ы _ н ъ _ а н э ё с ӄ э в _ ы м
алымъым чит нин нрычвойгымъым	а ы м ъ ы м ч и т _ н и н н р _ ы ч в _ о й г ы м _ ъ ы м
гагтылыляпэвым ынӄоръым	г а г т ы ы я п э в ы м _ ы н ӄ о р ъ ы м
о’ралвагты тывэтгаквъак	о ’ р а в а г т ы т ы в _ э т г а к в ъ а к
йынрысӄ мыткэӈкэленмык ӈайгыпы ынӄо мытръэт йынрысӄыткыната мытрагтытылякванмык	й ы н р ы с ӄ м ы т к э ӈ к э _ е н м ы к _ ӈ а й г ы п ы ы н ӄ о м ы т р ъ э т _ й ы н р _ ы с ӄ _ ы т к ы н а т а м ы т р _ а г т ы т ы я _ к в а н м ы к
наӄам мачгыргочаъымэ ӄаагтатыльын у’рэӈунрилы ааӄы’м ынӄэн йи га га гаканъёт нэна нэнарэӈатӄэнат ӈалвыльэты	н а ӄ а м м а ч г ы р г о ч а _ ъ ы м _ э ӄ а а г т а т ы ь ы н у ’ р _ э ӈ у н р и _ ы а а ӄ ы ’ м _ ы н ӄ э н й и г а _ га _ г а к а н ъёт _ н э н а _ н э н а р _ э ӈ а т ӄ э н а т _ ӈ а в _ ы ь э т ы
ы’мтъом ръэнут торыкагты мыльуэ’н ръэнут мытэйкыгъэн ръэнут мыныгйивэвын	ы ’ м т ъ о м р ъ э н у т _ т о р ы к а г т ы м ы ь _ у _ э ’ н _ р ъ э н у т м ы т э й к ы г ъ э н р ъ э н у т _ м ы н _ ы г й и в э в ы н _
онмальынъам ивнин о раӄычгатыркын	о н м а ь ы н ъ а м _ и в н и н о р а ӄ ы ч г а т _ ы р к ы н _
нан ярак ынӈин ӄитыркын ыныкит равъэчгатгъам миӈкыри мытрэнрэӄэквыт миӈкыри мытрэнтыгыт	н а н я р а к ы н ӈ и н ӄ и т ы р к ы н _ ы н ы к и т _ р а в _ ъ э ч _ г а т _ г ъ а м _ м и ӈ к ы р и м ы т р э н р э ӄ э к в ы т _ м и ӈ к ы р и _ м ы т р э н т ы г ы т
нанъяачьым люут лыгэмайӈыпэгляъэ янра иргъи ӄол нэмэ вальым	н а н ъ я а ч ь ы м ю _ у т ы г _ э м а й ӈ _ ы п э г я ъ э я н р а и р г ъ и ӄ о н э м э _ в а _ ь _ ы м _
нанъяачьым ынӄэн гыргочаткыныкъым янра	н а н ъ я а ч ь ы м ы н ӄ э н _ г ы р г о ч а т к ы н ы к ъ ы м _ я н р а _
ынӄэ нэгитээ’н эвын ынӄэн валыӈэ льоо	ы н ӄ э н э г и т э _ э ’ н э в ы н _ ы н ӄ э н в а ы ӈ э _ ь _ о о _
ытръэч ивнин титъэм рэрэн	ы т р ъ э ч и в н и н т и т ъ э м _ р э р _ э н _
ӄыгитъэм вае	ӄ ы г и т ъ э м в а е _
ы’ттъыгрына льунин ӈэвысӄэт итэй	ы ’ т т ъ ы г р ы н а ь _ у н и н ӈ э в ы с ӄ э т и т _ э й
эй йыӄӄэй ивкэ вулӄытви вайыкы мылёогъа	э й й ы ӄ ӄ э й и в к э в _ у ӄ _ ы т в _ и _ в а й ы к ы м ы ё о г ъ а _
чама мрэнэ нэлгинуюркыни нэлгинуйывмыкы	ч а м а м р э н э н э г _ и н у _ ю р к ы н _ и н э г и н у й ы в _ м ы к ы
чама нылылептилръуӄинэт элёльыльэтъым	ч а м а н ы ы е п т _ и р ъ у ӄ и н э т _ э ё ь ы _ ь э т ъ ы м
